Address,Occupied,Vacant,Owned_Loan,Owned_Clear,Renter_Occupied,TotalVacant_HUnits,ForRent,Rented_NotOccupied,ForSale,Sold_NotOccupied,Occasional_Use,MigrantWorkers,OtherVacant,H_White,H_AfricanAmerican,H_AmerIndian_Alaska,H_Asian,H_Hawaiian_Pacific,H_OtherRace,H_TwoOrMore_Races,Pop_Occ_HUnits,H_1P,H_2P,H_3P,H_4P,H_5P,H_6P,H_7MP,Owner_Occupied,Owner_Child_U18,Owner_NoChild_U18,Renter_Occupied,Renter_Child_U18,Renter_NoChild_U18,VacancyStatus_A,VacancyStatus_NA
"0 block academy green, Syracuse, NY",36,4,22,7,7,4,2,1,0,0,0,0,1,27,7,0,1,0,1,0,80,13,10,7,5,0,1,0,29,6,23,7,3,4,0,4
"0 block bear st, Syracuse, NY",0,0,0,0,0,0,0,0,0,0,0,0,0,0,0,0,0,0,0,0,0,0,0,0,0,0,0,0,0,0,0,0,0,0,0,0
"0 block bellevue ave, Syracuse, NY",54,1,9,4,41,1,0,0,1,0,0,0,0,29,21,0,0,0,3,1,198,6,12,9,9,12,3,3,13,5,8,41,28,13,0,1
"0 block cannon st, Syracuse, NY",30,4,12,2,16,4,1,0,0,0,0,0,3,3,25,0,0,0,2,0,113,2,2,14,4,4,2,2,14,7,7,16,11,5,0,4
"0 block catherine st, Syracuse, NY",0,0,0,0,0,0,0,0,0,0,0,0,0,0,0,0,0,0,0,0,0,0,0,0,0,0,0,0,0,0,0,0,0,0,0,0
"0 block childrens cir, Syracuse, NY",7,6,0,0,7,6,2,0,0,0,0,0,4,7,0,0,0,0,0,0,12,2,5,0,0,0,0,0,0,0,0,7,0,7,0,6
"0 block clinton st, Syracuse, NY",30,0,0,0,30,0,0,0,0,0,0,0,0,29,0,0,0,0,0,1,35,25,5,0,0,0,0,0,0,0,0,30,0,30,0,0
"0 block comstock av, Syracuse, NY",12,0,11,1,0,0,0,0,0,0,0,0,0,11,0,0,1,0,0,0,26,2,8,0,2,0,0,0,12,0,12,0,0,0,0,0
"0 block corcoran ct, Syracuse, NY",0,0,0,0,0,0,0,0,0,0,0,0,0,0,0,0,0,0,0,0,0,0,0,0,0,0,0,0,0,0,0,0,0,0,0,0
"0 block costello ct, Syracuse, NY",28,0,7,18,3,0,0,0,0,0,0,0,0,25,2,0,1,0,0,0,37,19,9,0,0,0,0,0,25,1,24,3,0,3,0,0
"0 block destiny usa dr, Syracuse, NY",51,4,31,19,1,4,2,0,1,0,0,0,1,46,5,0,0,0,0,0,103,16,23,8,3,1,0,0,50,9,41,1,0,1,0,4
"0 block dupli park dr, Syracuse, NY",0,0,0,0,0,0,0,0,0,0,0,0,0,0,0,0,0,0,0,0,0,0,0,0,0,0,0,0,0,0,0,0,0,0,0,0
"0 block elmhurst av, Syracuse, NY",4,0,3,0,1,0,0,0,0,0,0,0,0,1,3,0,0,0,0,0,9,1,2,0,1,0,0,0,3,1,2,1,1,0,0,0
"0 block fayette st, Syracuse, NY",0,0,0,0,0,0,0,0,0,0,0,0,0,0,0,0,0,0,0,0,0,0,0,0,0,0,0,0,0,0,0,0,0,0,0,0
"0 block geddes st s, Syracuse, NY",39,3,7,8,24,3,1,0,1,0,0,0,1,21,13,0,0,0,3,2,109,11,10,4,8,3,2,1,15,8,7,24,10,14,0,3
"0 block hatch st, Syracuse, NY",39,6,17,5,17,6,2,0,0,0,1,0,3,6,31,1,0,0,0,1,119,11,10,6,2,2,5,3,22,3,19,17,13,4,0,6
"0 block hawley av, Syracuse, NY",76,10,9,11,56,10,6,0,0,0,0,0,4,38,29,0,4,0,2,3,210,25,22,10,4,9,4,2,20,3,17,56,25,31,0,10
"0 block highland st, Syracuse, NY",43,8,9,4,30,8,2,0,0,0,0,0,6,19,12,0,8,0,1,3,139,9,12,7,5,2,3,5,13,5,8,30,17,13,1,7
"0 block james heath rd, Syracuse, NY",37,1,15,3,19,1,0,0,0,0,1,0,0,31,6,0,0,0,0,0,89,11,13,9,1,1,1,1,18,3,15,19,7,12,0,1
"0 block kenmore av, Syracuse, NY",111,29,47,16,48,29,7,0,0,0,0,0,22,20,83,0,0,0,1,7,320,22,26,34,12,9,6,2,63,19,44,48,29,19,0,29
"0 block kingsley pl, Syracuse, NY",80,12,8,6,66,12,5,0,0,0,1,0,6,70,4,2,0,0,0,4,181,34,21,9,9,2,3,2,14,5,9,66,18,48,0,12
"0 block kirk park dr, Syracuse, NY",31,4,12,7,12,4,0,0,0,0,0,0,4,10,17,1,0,0,1,2,100,8,4,5,6,5,2,1,19,10,9,12,7,5,0,4
"0 block lawrence st, Syracuse, NY",49,5,7,4,38,5,3,0,0,0,0,0,2,20,18,2,7,0,0,2,119,20,13,5,3,4,2,2,11,2,9,38,17,21,0,5
"0 block marshall st, Syracuse, NY",11,0,0,0,11,0,0,0,0,0,0,0,0,10,0,0,0,0,0,1,30,3,1,3,4,0,0,0,0,0,0,11,0,11,0,0
"0 block mertens av, Syracuse, NY",20,4,7,4,9,4,0,0,0,0,0,0,4,15,5,0,0,0,0,0,40,10,5,1,3,1,0,0,11,3,8,9,3,6,0,4
"0 block nursery ln, Syracuse, NY",0,0,0,0,0,0,0,0,0,0,0,0,0,0,0,0,0,0,0,0,0,0,0,0,0,0,0,0,0,0,0,0,0,0,0,0
"0 block onondaga av, Syracuse, NY",29,3,8,6,15,3,3,0,0,0,0,0,0,1,23,2,0,0,0,3,91,5,8,4,8,2,1,1,14,7,7,15,6,9,0,3
"0 block onondaga creek walk, Syracuse, NY",58,8,16,6,36,8,0,0,7,0,0,0,1,17,39,1,0,0,0,1,140,19,16,11,7,3,1,1,22,9,13,36,13,23,0,8
"0 block onondaga st, Syracuse, NY",0,0,0,0,0,0,0,0,0,0,0,0,0,0,0,0,0,0,0,0,0,0,0,0,0,0,0,0,0,0,0,0,0,0,0,0
"0 block park and lakeview av, Syracuse, NY",56,14,7,6,43,14,7,0,0,0,0,0,7,39,13,0,0,0,2,2,122,25,13,9,4,3,1,1,13,3,10,43,11,32,0,14
"0 block predential plz, Syracuse, NY",0,0,0,0,0,0,0,0,0,0,0,0,0,0,0,0,0,0,0,0,0,0,0,0,0,0,0,0,0,0,0,0,0,0,0,0
"0 block presidential ct, Syracuse, NY",0,0,0,0,0,0,0,0,0,0,0,0,0,0,0,0,0,0,0,0,0,0,0,0,0,0,0,0,0,0,0,0,0,0,0,0
"0 block presidential plz, Syracuse, NY",0,0,0,0,0,0,0,0,0,0,0,0,0,0,0,0,0,0,0,0,0,0,0,0,0,0,0,0,0,0,0,0,0,0,0,0
"0 block robincroft rd, Syracuse, NY",90,11,29,9,52,11,3,0,2,0,0,0,6,58,18,3,2,0,3,6,223,25,34,11,7,10,2,1,38,8,30,52,20,32,0,11
"0 block schoeneck ct, Syracuse, NY",18,8,1,1,16,8,0,0,5,2,0,0,1,10,2,0,0,0,5,1,42,6,8,0,1,2,1,0,2,1,1,16,4,12,1,7
"0 block seymour st, Syracuse, NY",61,11,7,6,48,11,3,1,0,1,0,0,6,41,15,1,0,0,1,3,131,37,5,7,3,5,3,1,13,3,10,48,12,36,2,9
"0 block shonnard st, Syracuse, NY",32,12,7,4,21,12,3,0,0,0,0,0,9,14,7,0,0,0,9,2,102,9,5,5,6,2,3,2,11,7,4,21,9,12,1,11
"0 block state st s, Syracuse, NY",42,3,0,0,42,3,1,0,0,0,1,0,1,0,38,0,0,0,3,1,76,20,14,4,4,0,0,0,0,0,0,42,19,23,0,3
"0 block taylor st e, Syracuse, NY",0,0,0,0,0,0,0,0,0,0,0,0,0,0,0,0,0,0,0,0,0,0,0,0,0,0,0,0,0,0,0,0,0,0,0,0
"0 block townsend st s, Syracuse, NY",1,1,0,1,0,1,0,0,0,0,0,0,1,1,0,0,0,0,0,0,4,0,0,0,1,0,0,0,1,1,0,0,0,0,0,1
"0 block weiser ct, Syracuse, NY",1,1,0,0,1,1,0,0,0,0,0,0,1,0,1,0,0,0,0,0,1,1,0,0,0,0,0,0,0,0,0,1,0,1,0,1
"0 block wellesley rd, Syracuse, NY",28,0,16,2,10,0,0,0,0,0,0,0,0,17,8,1,0,0,1,1,71,6,9,6,6,1,0,0,18,8,10,10,4,6,0,0
"0 block will ct, Syracuse, NY",0,0,0,0,0,0,0,0,0,0,0,0,0,0,0,0,0,0,0,0,0,0,0,0,0,0,0,0,0,0,0,0,0,0,0,0
"100 block albert ter, Syracuse, NY",0,0,0,0,0,0,0,0,0,0,0,0,0,0,0,0,0,0,0,0,0,0,0,0,0,0,0,0,0,0,0,0,0,0,0,0
"100 block alexander av, Syracuse, NY",7,8,1,0,6,8,0,3,0,1,0,0,4,1,4,0,0,0,0,2,28,1,2,1,1,1,0,1,1,0,1,6,3,3,0,8
"100 block amherst av, Syracuse, NY",76,19,5,8,63,19,7,2,0,0,0,0,10,10,63,0,1,0,0,2,214,22,17,11,13,7,4,2,13,3,10,63,37,26,1,18
"100 block angelou ter, Syracuse, NY",5,0,1,0,4,0,0,0,0,0,0,0,0,0,5,0,0,0,0,0,10,2,2,0,1,0,0,0,1,0,1,4,1,3,0,0
"100 block annetta st, Syracuse, NY",2,4,0,0,2,4,2,0,0,0,0,0,2,1,1,0,0,0,0,0,2,2,0,0,0,0,0,0,0,0,0,2,0,2,0,4
"100 block archer rd, Syracuse, NY",14,1,10,3,1,1,0,0,0,0,0,0,1,14,0,0,0,0,0,0,27,5,6,2,1,0,0,0,13,3,10,1,0,1,0,1
"100 block arnett av, Syracuse, NY",81,10,20,9,52,10,9,0,0,0,0,0,1,70,4,2,1,0,1,3,131,49,20,6,6,0,0,0,29,6,23,52,3,49,0,10
"100 block arnts pl, Syracuse, NY",49,3,29,6,14,3,1,0,0,0,0,0,2,44,3,0,1,0,1,0,117,16,17,6,5,3,1,1,35,8,27,14,5,9,0,3
"100 block arsenal dr, Syracuse, NY",48,1,14,2,32,1,0,0,0,0,0,0,1,9,35,1,0,0,1,2,131,10,15,8,9,5,1,0,16,7,9,32,20,12,0,1
"100 block ash st, Syracuse, NY",77,24,3,7,67,24,7,3,0,2,0,0,12,31,23,0,18,0,3,2,226,20,13,13,16,13,2,0,10,3,7,67,37,30,14,10
"100 block avery av, Syracuse, NY",38,1,24,13,1,1,0,0,1,0,0,0,0,36,1,0,0,1,0,0,85,9,18,7,2,1,1,0,37,8,29,1,1,0,0,1
"100 block avon rd, Syracuse, NY",54,4,27,17,10,4,0,0,3,1,0,0,0,53,0,0,0,0,0,1,118,15,25,6,5,3,0,0,44,11,33,10,0,10,1,3
"100 block baldwin av, Syracuse, NY",46,3,8,8,30,3,1,0,0,0,0,0,2,8,35,0,0,0,1,2,117,15,14,5,8,0,2,2,16,0,16,30,20,10,0,3
"100 block ballard av, Syracuse, NY",136,16,35,21,80,16,9,0,2,0,0,0,5,16,115,0,0,0,1,4,416,25,34,33,19,14,4,7,56,19,37,80,53,27,2,14
"100 block beard av e, Syracuse, NY",16,3,1,1,14,3,1,0,0,0,0,0,2,2,13,0,0,0,1,0,46,3,5,2,5,0,0,1,2,1,1,14,7,7,0,3
"100 block beard av w, Syracuse, NY",27,11,4,4,19,11,1,0,0,0,0,0,10,2,24,0,0,0,1,0,81,5,7,5,7,1,0,2,8,2,6,19,11,8,0,11
"100 block beattie st, Syracuse, NY",24,0,7,9,8,0,0,0,0,0,0,0,0,21,1,0,2,0,0,0,40,12,8,4,0,0,0,0,16,0,16,8,0,8,0,0
"100 block becker st, Syracuse, NY",47,6,16,6,25,6,1,0,0,0,1,0,4,40,3,0,2,0,0,2,109,16,13,10,6,0,1,1,22,7,15,25,10,15,0,6
"100 block beech st s, Syracuse, NY",34,2,10,6,18,2,0,0,0,0,1,0,1,2,32,0,0,0,0,0,81,10,15,4,1,2,1,1,16,4,12,18,5,13,0,2
"100 block berger av, Syracuse, NY",17,8,3,2,12,8,0,0,0,0,0,0,8,2,13,0,0,0,1,1,66,0,2,4,7,3,0,1,5,3,2,12,9,3,5,3
"100 block berkshire av, Syracuse, NY",4,1,1,2,1,1,1,0,0,0,0,0,0,4,0,0,0,0,0,0,8,1,2,1,0,0,0,0,3,0,3,1,0,1,0,1
"100 block berwyn av, Syracuse, NY",31,5,9,7,15,5,4,0,0,0,0,0,1,3,27,0,0,0,1,0,97,6,8,6,5,2,2,2,16,6,10,15,10,5,1,4
"100 block bissell st e, Syracuse, NY",31,4,6,3,22,4,2,0,0,0,0,0,2,3,28,0,0,0,0,0,82,10,7,5,4,4,0,1,9,3,6,22,11,11,0,4
"100 block bissell st w, Syracuse, NY",49,9,18,7,24,9,1,1,2,0,0,0,5,19,23,0,0,0,3,4,131,16,14,4,6,5,2,2,25,8,17,24,11,13,0,9
"100 block blossom rd, Syracuse, NY",109,2,60,19,30,2,0,0,0,0,0,0,2,48,57,0,0,0,0,4,289,25,40,15,15,10,2,2,79,25,54,30,15,15,0,2,0,0,0,0,0,0,0,0,0,0,0,0,0,0,0,0
"100 block bristol pl, Syracuse, NY",63,4,1,2,60,4,2,0,0,0,0,0,2,44,4,0,12,0,2,1,143,23,12,21,3,3,1,0,3,0,3,60,2,58,0,4
"100 block broad st, Syracuse, NY",69,4,12,2,55,4,2,0,0,0,1,0,1,56,3,0,7,1,2,0,209,6,14,25,20,4,0,0,14,6,8,55,1,54,0,4
"100 block bronson st, Syracuse, NY",81,5,53,19,9,5,0,0,2,0,0,0,3,68,10,2,0,0,0,1,202,24,23,14,12,6,2,0,72,21,51,9,4,5,0,5
"100 block brookford rd, Syracuse, NY",0,0,0,0,0,0,0,0,0,0,0,0,0,0,0,0,0,0,0,0,0,0,0,0,0,0,0,0,0,0,0,0,0,0,0,0
"100 block burnet park dr, Syracuse, NY",71,8,25,11,35,8,4,0,2,1,0,0,1,69,1,0,0,0,1,0,145,27,28,7,5,3,1,0,36,9,27,35,4,31,0,8
"100 block burt st, Syracuse, NY",0,9,0,0,0,9,0,0,0,0,0,0,9,0,0,0,0,0,0,0,0,0,0,0,0,0,0,0,0,0,0,0,0,0,1,8
"100 block camp av, Syracuse, NY",63,4,21,8,34,4,2,0,0,1,0,0,1,51,10,0,0,0,0,2,157,19,17,14,8,3,1,1,29,10,19,34,9,25,0,4
"100 block cannon st, Syracuse, NY",38,4,7,8,23,4,1,0,0,0,0,0,3,3,32,0,0,0,1,2,109,7,13,7,6,2,1,2,15,6,9,23,13,10,1,3
"100 block carbon st s, Syracuse, NY",113,19,18,12,83,19,7,0,0,1,0,0,11,62,30,1,8,1,0,11,337,35,32,13,9,10,6,8,30,6,24,83,42,41,1,18
"100 block centennial dr, Syracuse, NY",33,2,19,7,7,2,0,0,0,2,0,0,0,26,6,0,0,0,0,1,88,6,12,8,2,4,1,0,26,5,21,7,2,5,0,2
"100 block chaffee av  e, Syracuse, NY",13,0,6,1,6,0,0,0,0,0,0,0,0,10,3,0,0,0,0,0,33,3,5,1,3,1,0,0,7,1,6,6,3,3,0,0
"100 block chaffee av, Syracuse, NY",25,1,13,3,9,1,0,0,0,0,0,0,1,19,3,1,0,0,2,0,47,11,8,5,0,1,0,0,16,3,13,9,0,9,1,0
"100 block charmouth dr, Syracuse, NY",21,6,8,6,7,6,0,0,3,0,0,0,3,10,7,1,0,0,0,3,58,8,5,0,3,2,3,0,14,5,9,7,3,4,0,6
"100 block cheltenham rd e, Syracuse, NY",31,0,19,10,2,0,0,0,0,0,0,0,0,24,6,0,0,0,0,1,76,7,10,9,4,0,1,0,29,9,20,2,0,2,0,0
"100 block cheney st, Syracuse, NY",21,4,2,1,18,4,2,0,1,0,0,0,1,8,10,0,0,0,2,1,55,5,4,7,4,1,0,0,3,3,0,18,8,10,0,4
"100 block clairmonte av, Syracuse, NY",60,4,23,2,35,4,1,0,2,0,0,0,1,34,20,1,0,0,3,2,176,10,21,10,9,5,3,2,25,7,18,35,22,13,0,4
"100 block clarendon st, Syracuse, NY",48,0,10,5,33,0,0,0,0,0,0,0,0,36,5,0,5,0,0,2,144,5,12,19,5,5,1,1,15,8,7,33,4,29,0,0
"100 block clarke st, Syracuse, NY",87,6,35,12,40,6,1,0,0,0,0,0,5,69,9,0,6,0,0,3,207,27,26,16,13,2,3,0,47,16,31,40,8,32,0,6
"100 block clinton st s, Syracuse, NY",0,0,0,0,0,0,0,0,0,0,0,0,0,0,0,0,0,0,0,0,0,0,0,0,0,0,0,0,0,0,0,0,0,0,0,0
"100 block clyde av, Syracuse, NY",14,0,9,0,5,0,0,0,0,0,0,0,0,8,6,0,0,0,0,0,27,4,7,3,0,0,0,0,9,1,8,5,1,4,0,0
"100 block collingwood av n, Syracuse, NY",40,1,24,8,8,1,0,0,0,0,0,0,1,38,2,0,0,0,0,0,91,11,17,6,4,0,2,0,32,8,24,8,2,6,0,1
"100 block colvin st e, Syracuse, NY",50,3,29,11,10,3,0,0,1,0,0,0,2,41,5,0,0,0,0,4,93,22,17,8,2,1,0,0,40,3,37,10,3,7,0,3
"100 block commonwealth av, Syracuse, NY",67,7,12,9,46,7,2,0,0,0,0,0,5,49,13,0,2,0,0,3,171,22,19,10,5,6,4,1,21,3,18,46,21,25,0,7
"100 block concord pl, Syracuse, NY",55,2,24,7,24,2,2,0,0,0,0,0,0,46,5,0,1,0,2,1,151,12,16,6,16,5,0,0,31,12,19,24,0,24,0,2
"100 block conifer dr, Syracuse, NY",0,0,0,0,0,0,0,0,0,0,0,0,0,0,0,0,0,0,0,0,0,0,0,0,0,0,0,0,0,0,0,0,0,0,0,0
"100 block cook av, Syracuse, NY",0,0,0,0,0,0,0,0,0,0,0,0,0,0,0,0,0,0,0,0,0,0,0,0,0,0,0,0,0,0,0,0,0,0,0,0
"100 block coolidge av, Syracuse, NY",0,0,0,0,0,0,0,0,0,0,0,0,0,0,0,0,0,0,0,0,0,0,0,0,0,0,0,0,0,0,0,0,0,0,0,0
"100 block cordova st, Syracuse, NY",14,2,7,2,5,2,1,0,0,0,0,0,1,0,14,0,0,0,0,0,43,4,2,3,2,0,3,0,9,4,5,5,3,2,0,2
"100 block corning av e, Syracuse, NY",27,1,20,4,3,1,0,0,0,0,1,0,0,21,5,0,0,0,1,0,61,9,7,6,5,0,0,0,24,8,16,3,1,2,0,1
"100 block corning av w, Syracuse, NY",33,3,8,10,15,3,2,0,1,0,0,0,0,11,22,0,0,0,0,0,90,10,9,5,4,2,2,1,18,4,14,15,10,5,0,3
"100 block cortland pl, Syracuse, NY",23,1,1,0,22,1,1,0,0,0,0,0,0,8,12,0,0,0,0,3,44,9,7,7,0,0,0,0,1,0,1,22,6,16,0,1
"100 block court st w, Syracuse, NY",17,0,9,7,1,0,0,0,0,0,0,0,0,14,3,0,0,0,0,0,42,5,7,3,0,0,1,1,16,6,10,1,0,1,0,0
"100 block court ter, Syracuse, NY",132,12,29,15,88,12,10,0,0,0,0,0,2,93,13,8,7,0,8,3,368,37,31,27,14,9,11,3,44,14,30,88,41,47,0,12
"100 block craton st, Syracuse, NY",113,11,7,12,94,11,1,0,0,0,1,0,9,67,25,1,9,0,4,7,310,30,30,23,14,10,1,5,19,5,14,94,42,52,0,11
"100 block crawford av, Syracuse, NY",68,1,28,11,29,1,0,0,0,0,1,0,0,58,4,0,4,0,0,2,177,14,24,15,9,5,0,1,39,13,26,29,7,22,0,1
"100 block cresline dr, Syracuse, NY",62,2,40,12,10,2,0,0,0,0,0,0,2,59,3,0,0,0,0,0,144,21,19,12,5,3,1,1,52,18,34,10,2,8,0,2
"100 block croly st, Syracuse, NY",0,0,0,0,0,0,0,0,0,0,0,0,0,0,0,0,0,0,0,0,0,0,0,0,0,0,0,0,0,0,0,0,0,0,0,0
"100 block crouse av s, Syracuse, NY",78,1,43,18,17,1,1,0,0,0,0,0,0,58,14,0,3,0,0,3,156,38,23,5,7,3,0,2,61,6,55,17,4,13,0,1
"100 block crysler st, Syracuse, NY",1,0,0,1,0,0,0,0,0,0,0,0,0,1,0,0,0,0,0,0,1,1,0,0,0,0,0,0,1,0,1,0,0,0,0,0
"100 block curtis st, Syracuse, NY",0,0,0,0,0,0,0,0,0,0,0,0,0,0,0,0,0,0,0,0,0,0,0,0,0,0,0,0,0,0,0,0,0,0,0,0
"100 block dablon ct, Syracuse, NY",46,0,0,0,46,0,0,0,0,0,0,0,0,5,40,0,0,0,1,0,80,27,11,4,2,1,1,0,0,0,0,46,14,32,0,0
"100 block daisy st, Syracuse, NY",129,17,7,3,119,17,13,0,0,0,0,0,4,44,76,1,1,0,7,0,222,82,27,6,6,5,2,1,10,4,6,119,21,98,0,17
"100 block dakin st, Syracuse, NY",16,6,3,1,12,6,1,0,0,0,0,0,5,4,10,0,0,0,2,0,46,2,6,4,1,2,1,0,4,2,2,12,4,8,0,6
"100 block dale st, Syracuse, NY",62,10,24,13,25,10,1,0,1,0,0,0,8,43,11,1,6,0,0,1,160,21,15,15,3,4,2,2,37,5,32,25,12,13,0,10
"100 block danforth ter, Syracuse, NY",0,0,0,0,0,0,0,0,0,0,0,0,0,0,0,0,0,0,0,0,0,0,0,0,0,0,0,0,0,0,0,0,0,0,0,0
"100 block dearborn pl, Syracuse, NY",0,0,0,0,0,0,0,0,0,0,0,0,0,0,0,0,0,0,0,0,0,0,0,0,0,0,0,0,0,0,0,0,0,0,0,0
"100 block delaware st, Syracuse, NY",26,15,8,3,15,15,0,0,0,0,0,0,15,5,15,1,0,0,2,3,69,9,5,3,4,5,0,0,11,3,8,15,7,8,1,14
"100 block delong av, Syracuse, NY",76,22,2,6,68,22,5,0,0,0,0,0,17,34,23,3,14,0,0,2,227,20,22,11,7,4,6,6,8,2,6,68,32,36,0,22
"100 block delray av, Syracuse, NY",47,2,26,10,11,2,1,0,0,0,0,0,1,18,28,0,0,0,0,1,124,9,19,8,7,1,1,2,36,10,26,11,6,5,0,2
"100 block dewey av, Syracuse, NY",86,25,9,10,67,25,15,0,0,0,0,0,10,55,19,1,0,0,7,4,216,33,19,15,9,5,2,3,19,4,15,67,30,37,0,25
"100 block dickerson st, Syracuse, NY",0,0,0,0,0,0,0,0,0,0,0,0,0,0,0,0,0,0,0,0,0,0,0,0,0,0,0,0,0,0,0,0,0,0,0,0
"100 block division st w, Syracuse, NY",7,2,0,0,7,2,2,0,0,0,0,0,0,1,5,0,0,0,0,1,31,0,1,3,0,1,1,1,0,0,0,7,4,3,0,2
"100 block doll pkwy, Syracuse, NY",87,3,71,15,1,3,0,0,0,1,0,0,2,65,19,0,3,0,0,0,183,32,33,11,6,3,1,1,86,22,64,1,1,0,1,2
"100 block duane st, Syracuse, NY",58,1,28,8,22,1,0,0,0,1,0,0,0,45,7,1,1,0,3,1,133,17,20,10,9,2,0,0,36,11,25,22,11,11,0,1
"100 block dudley st, Syracuse, NY",49,11,5,2,42,11,2,0,0,0,0,0,9,19,19,1,0,0,6,4,161,9,11,11,6,6,4,2,7,4,3,42,20,22,0,11
"100 block durston av, Syracuse, NY",55,5,31,22,2,5,0,0,0,0,2,0,3,54,0,0,1,0,0,0,128,12,22,14,5,2,0,0,53,16,37,2,1,1,0,5
"100 block east av, Syracuse, NY",64,3,45,10,9,3,0,0,0,0,0,0,3,23,40,0,1,0,0,0,157,16,23,12,10,1,0,2,55,14,41,9,5,4,1,2
"100 block eastman av, Syracuse, NY",24,10,7,4,13,10,1,0,1,0,0,0,8,4,19,0,0,0,0,1,41,11,10,2,1,0,0,0,11,0,11,13,4,9,1,9
"100 block edison st, Syracuse, NY",0,0,0,0,0,0,0,0,0,0,0,0,0,0,0,0,0,0,0,0,0,0,0,0,0,0,0,0,0,0,0,0,0,0,0,0
"100 block edmund av, Syracuse, NY",41,3,18,8,15,3,0,0,2,0,0,0,1,13,27,0,0,0,1,0,102,13,13,5,4,4,2,0,26,5,21,15,9,6,1,2
"100 block edwards av n, Syracuse, NY",3,0,2,1,0,0,0,0,0,0,0,0,0,3,0,0,0,0,0,0,3,3,0,0,0,0,0,0,3,0,3,0,0,0,0,0
"100 block elizabeth blackwell st, Syracuse, NY",0,0,0,0,0,0,0,0,0,0,0,0,0,0,0,0,0,0,0,0,0,0,0,0,0,0,0,0,0,0,0,0,0,0,0,0
"100 block elk st, Syracuse, NY",68,15,15,13,40,15,2,0,1,0,0,0,12,10,53,0,0,0,4,1,176,24,14,18,2,4,3,3,28,5,23,40,18,22,0,15
"100 block elliott st, Syracuse, NY",35,13,7,3,25,13,2,0,0,0,0,0,11,10,16,2,0,0,4,3,98,8,9,8,4,4,2,0,10,3,7,25,16,9,0,13
"100 block elmhurst av, Syracuse, NY",35,9,15,6,14,9,6,0,0,0,0,0,3,11,22,1,0,0,0,1,99,8,8,6,9,3,1,0,21,5,16,14,8,6,1,8
"100 block eloise ter, Syracuse, NY",202,74,42,9,151,74,45,0,4,1,0,0,24,65,106,0,1,0,16,14,551,54,45,54,19,18,7,5,51,18,33,151,82,69,1,73
"100 block elsner st, Syracuse, NY",39,8,8,6,25,8,2,1,0,0,0,0,5,23,11,0,4,1,0,0,93,18,7,1,9,2,2,0,14,3,11,25,7,18,0,8
"100 block emerson av, Syracuse, NY",19,2,5,2,12,2,0,0,0,0,0,0,2,17,0,1,0,0,0,1,33,11,5,0,3,0,0,0,7,1,6,12,3,9,0,2
"100 block erickson st, Syracuse, NY",44,0,9,2,33,0,0,0,0,0,0,0,0,35,7,1,0,0,0,1,64,30,11,1,1,1,0,0,11,1,10,33,1,32,0,0
"100 block erie blvd e, Syracuse, NY",0,0,0,0,0,0,0,0,0,0,0,0,0,0,0,0,0,0,0,0,0,0,0,0,0,0,0,0,0,0,0,0,0,0,0,0
"100 block ethel st, Syracuse, NY",17,2,9,7,1,2,0,0,1,0,0,0,1,15,2,0,0,0,0,0,36,4,9,3,0,1,0,0,16,1,15,1,0,1,0,2
"100 block eureka st, Syracuse, NY",45,11,6,1,38,11,1,6,0,0,0,0,4,34,10,0,0,0,0,1,86,23,11,6,2,3,0,0,7,2,5,38,7,31,0,11
"100 block fage av, Syracuse, NY",16,5,1,1,14,5,3,0,0,0,0,0,2,2,14,0,0,0,0,0,54,2,4,4,0,4,2,0,2,1,1,14,10,4,0,5
"100 block feigel av, Syracuse, NY",160,32,7,4,149,32,29,0,0,0,2,0,1,131,13,2,8,0,2,4,238,94,54,12,0,0,0,0,11,4,7,149,14,135,0,32
"100 block fellows av, Syracuse, NY",72,6,21,6,45,6,1,0,1,2,0,0,2,52,12,1,4,0,0,3,181,23,21,9,11,5,2,1,27,6,21,45,4,41,0,6
"100 block fenton st, Syracuse, NY",23,8,3,4,16,8,7,0,0,0,0,0,1,8,8,0,0,0,4,3,63,5,8,3,5,0,1,1,7,2,5,16,7,9,0,8
"100 block fernwood av, Syracuse, NY",79,28,22,13,44,28,3,0,0,0,0,0,25,3,73,0,0,0,1,2,207,17,26,18,10,5,2,1,35,8,27,44,22,22,1,27
"100 block fish av, Syracuse, NY",27,1,18,7,2,1,0,0,0,1,0,0,0,16,11,0,0,0,0,0,61,8,11,3,3,2,0,0,25,6,19,2,0,2,0,1
"100 block florence av w, Syracuse, NY",144,15,42,9,93,15,10,0,0,0,0,0,5,35,99,3,0,0,0,7,383,25,50,35,24,6,2,2,51,14,37,93,58,35,0,15
"100 block fordham rd, Syracuse, NY",49,2,31,13,5,2,0,0,1,0,0,0,1,45,2,0,0,0,1,1,121,13,17,8,7,2,2,0,44,13,31,5,2,3,0,2
"100 block frisbie ct, Syracuse, NY",81,1,0,0,81,1,1,0,0,0,0,0,0,28,42,0,6,0,4,1,203,24,22,16,10,8,0,1,0,0,0,81,22,59,0,1
"100 block furman st, Syracuse, NY",0,0,0,0,0,0,0,0,0,0,0,0,0,0,0,0,0,0,0,0,0,0,0,0,0,0,0,0,0,0,0,0,0,0,0,0
"100 block geddes st n, Syracuse, NY",23,1,14,8,1,1,0,0,0,0,0,0,1,8,15,0,0,0,0,0,53,8,5,6,3,1,0,0,22,5,17,1,1,0,0,1
"100 block genesee park dr, Syracuse, NY",216,10,22,3,191,10,8,0,0,0,1,0,1,37,138,5,0,1,28,7,474,86,60,35,22,7,2,4,25,12,13,191,85,106,1,9
"100 block genesee pkwy e, Syracuse, NY",13,2,10,0,3,2,0,0,1,0,0,0,1,2,11,0,0,0,0,0,25,5,6,1,0,1,0,0,10,1,9,3,1,2,0,2
"100 block genesee st e, Syracuse, NY",13,1,7,1,5,1,0,0,0,0,0,0,1,6,6,0,0,0,0,1,35,3,4,2,2,2,0,0,8,2,6,5,5,0,1,0
"100 block gertrude st, Syracuse, NY",49,2,6,1,42,2,0,1,0,0,1,0,0,32,13,1,0,0,1,2,80,32,12,0,2,2,1,0,7,1,6,42,5,37,0,2
"100 block gifford pkwy, Syracuse, NY",45,2,26,13,6,2,1,0,0,0,1,0,0,31,11,0,2,0,0,1,102,12,19,7,5,1,1,0,39,9,30,6,3,3,0,2
"100 block gifford st, Syracuse, NY",5,0,1,0,4,0,0,0,0,0,0,0,0,1,1,3,0,0,0,0,7,3,2,0,0,0,0,0,1,0,1,4,0,4,0,0
"100 block glahn av, Syracuse, NY",39,6,2,1,36,6,3,0,0,0,0,0,3,8,29,0,0,0,1,1,128,2,8,12,12,4,1,0,3,1,2,36,23,13,0,6
"100 block glen av w, Syracuse, NY",61,0,39,20,2,0,0,0,0,0,0,0,0,49,9,2,0,0,1,0,129,25,21,9,2,1,1,2,59,7,52,2,0,2,0,0
"100 block goodrich av, Syracuse, NY",5,0,3,1,1,0,0,0,0,0,0,0,0,4,1,0,0,0,0,0,9,1,4,0,0,0,0,0,4,0,4,1,0,1,0,0
"100 block gordon av, Syracuse, NY",3,0,2,1,0,0,0,0,0,0,0,0,0,3,0,0,0,0,0,0,8,0,1,2,0,0,0,0,3,1,2,0,0,0,0,0
"100 block gorland av, Syracuse, NY",17,0,10,4,3,0,0,0,0,0,0,0,0,2,14,0,0,0,1,0,39,4,7,3,3,0,0,0,14,3,11,3,1,2,0,0
"100 block grand av, Syracuse, NY",111,33,14,10,87,33,10,0,0,0,0,0,23,50,34,6,1,0,15,5,304,33,27,16,19,7,6,3,24,5,19,87,40,47,0,33
"100 block granger st, Syracuse, NY",23,1,0,0,23,1,1,0,0,0,0,0,0,17,3,0,3,0,0,0,26,20,3,0,0,0,0,0,0,0,0,23,0,23,0,1
"100 block graves st, Syracuse, NY",98,32,2,3,93,32,12,0,0,0,0,0,20,40,38,0,9,0,2,9,237,46,12,17,7,11,2,3,5,0,5,93,36,57,3,29
"100 block green st, Syracuse, NY",120,49,0,0,120,49,20,0,0,0,0,0,29,74,33,1,5,0,2,5,180,91,16,5,3,2,1,2,0,0,0,120,14,106,0,49
"100 block griffin st, Syracuse, NY",7,2,1,2,4,2,0,0,0,0,0,0,2,1,5,1,0,0,0,0,25,1,2,1,1,1,0,1,3,1,2,4,3,1,0,2
"100 block griffiths st, Syracuse, NY",39,4,17,4,18,4,1,0,0,0,0,0,3,18,11,0,8,0,1,1,147,4,10,7,6,3,2,7,21,11,10,18,12,6,0,4
"100 block grove st, Syracuse, NY",39,3,23,5,11,3,0,0,1,0,0,0,2,21,17,0,0,0,1,0,98,11,13,9,2,0,2,2,28,8,20,11,6,5,0,3
"100 block harbor st, Syracuse, NY",37,4,14,7,16,4,1,0,0,0,0,0,3,34,2,0,0,0,0,1,99,13,10,3,7,0,1,3,21,4,17,16,9,7,0,4
"100 block harborside dr, Syracuse, NY",0,0,0,0,0,0,0,0,0,0,0,0,0,0,0,0,0,0,0,0,0,0,0,0,0,0,0,0,0,0,0,0,0,0,0,0
"100 block harrison st, Syracuse, NY",3,0,0,0,3,0,0,0,0,0,0,0,0,1,2,0,0,0,0,0,3,3,0,0,0,0,0,0,0,0,0,3,0,3,0,0
"100 block hartson st, Syracuse, NY",30,4,7,4,19,4,3,0,0,0,0,0,1,23,3,1,0,0,3,0,86,3,14,5,4,2,0,2,11,6,5,19,8,11,0,4
"100 block hatch st, Syracuse, NY",50,14,17,3,30,14,4,0,0,1,0,0,9,8,39,0,0,0,1,2,158,10,8,12,9,8,2,1,20,7,13,30,19,11,2,12
"100 block hatherly rd, Syracuse, NY",1,0,1,0,0,0,0,0,0,0,0,0,0,1,0,0,0,0,0,0,2,0,1,0,0,0,0,0,1,0,1,0,0,0,0,0
"100 block hawley av, Syracuse, NY",23,2,2,1,20,2,2,0,0,0,0,0,0,15,3,0,0,0,3,2,42,13,6,0,3,1,0,0,3,1,2,20,4,16,0,2
"100 block headson dr, Syracuse, NY",24,2,18,5,1,2,0,0,0,0,1,0,1,14,9,0,1,0,0,0,46,11,6,5,2,0,0,0,23,6,17,1,0,1,0,2
"100 block helen st, Syracuse, NY",27,2,5,1,21,2,0,0,0,0,0,0,2,18,6,0,1,0,2,0,57,9,8,8,2,0,0,0,6,2,4,21,6,15,0,2
"100 block henry st, Syracuse, NY",0,0,0,0,0,0,0,0,0,0,0,0,0,0,0,0,0,0,0,0,0,0,0,0,0,0,0,0,0,0,0,0,0,0,0,0
"100 block herkimer st, Syracuse, NY",70,5,14,14,42,5,3,0,0,0,0,0,2,62,5,1,0,0,1,1,135,25,31,9,4,1,0,0,28,2,26,42,12,30,0,5
"100 block hillsdale av, Syracuse, NY",14,1,2,0,12,1,1,0,0,0,0,0,0,13,1,0,0,0,0,0,31,3,7,2,2,0,0,0,2,1,1,12,4,8,0,1
"100 block hixson av, Syracuse, NY",37,9,9,14,14,9,5,0,1,0,1,0,2,30,6,0,0,0,0,1,82,11,18,3,2,1,1,1,23,2,21,14,7,7,0,9
"100 block homecroft av, Syracuse, NY",13,6,0,0,13,6,6,0,0,0,0,0,0,8,4,1,0,0,0,0,25,5,4,4,0,0,0,0,0,0,0,13,7,6,0,6
"100 block hood av, Syracuse, NY",62,5,14,7,41,5,1,0,0,0,1,0,3,44,14,1,1,0,0,2,147,25,18,8,4,3,1,3,21,6,15,41,12,29,0,5
"100 block hope av, Syracuse, NY",16,3,8,2,6,3,2,0,1,0,0,0,0,2,14,0,0,0,0,0,56,3,3,3,1,4,1,1,10,4,6,6,5,1,0,3
"100 block houston av, Syracuse, NY",51,4,31,19,1,4,2,0,1,0,0,0,1,46,5,0,0,0,0,0,103,16,23,8,3,1,0,0,50,9,41,1,0,1,0,4
"100 block hudson av, Syracuse, NY",66,8,31,15,20,8,0,0,0,1,0,0,7,44,19,0,1,0,0,2,146,22,22,14,3,4,1,0,46,9,37,20,6,14,0,8
"100 block hudson st, Syracuse, NY",30,8,12,4,14,8,2,0,0,0,0,0,6,3,24,1,0,0,0,2,102,6,8,6,2,2,1,5,16,9,7,14,9,5,1,7
"100 block huntley st, Syracuse, NY",43,5,27,10,6,5,1,0,0,0,0,0,4,36,5,0,1,0,0,1,114,8,18,5,6,5,1,0,37,10,27,6,3,3,1,4
"100 block hurlburt rd, Syracuse, NY",27,0,20,7,0,0,0,0,0,0,0,0,0,22,3,0,1,0,0,1,65,4,15,3,3,2,0,0,27,7,20,0,0,0,0,0
"100 block huron st, Syracuse, NY",48,9,20,9,19,9,2,0,1,0,0,0,6,7,40,0,0,0,0,1,118,21,8,9,2,5,1,2,29,4,25,19,12,7,0,9
"100 block intrepid ln, Syracuse, NY",26,3,12,9,5,3,0,0,0,0,0,0,3,23,3,0,0,0,0,0,56,11,8,4,1,0,1,1,21,3,18,5,3,2,0,3
"100 block isabella st, Syracuse, NY",0,0,0,0,0,0,0,0,0,0,0,0,0,0,0,0,0,0,0,0,0,0,0,0,0,0,0,0,0,0,0,0,0,0,0,0
"100 block jamesville av, Syracuse, NY",0,0,0,0,0,0,0,0,0,0,0,0,0,0,0,0,0,0,0,0,0,0,0,0,0,0,0,0,0,0,0,0,0,0,0,0
"100 block janet dr, Syracuse, NY",22,1,9,4,9,1,0,0,0,0,0,0,1,20,0,1,1,0,0,0,51,6,8,6,1,0,0,1,13,5,8,9,1,8,0,1
"100 block jasper pl, Syracuse, NY",86,15,8,8,70,15,4,0,0,0,0,0,11,38,24,2,15,0,1,6,265,30,17,11,7,6,4,11,16,5,11,70,32,38,1,14
"100 block jasper st, Syracuse, NY",50,7,10,6,34,7,2,0,0,1,0,0,4,36,4,0,8,0,0,2,158,6,21,6,5,7,2,3,16,7,9,34,18,16,0,7
"100 block jefferson st e, Syracuse, NY",46,9,17,4,25,9,5,1,1,1,0,0,1,26,15,4,0,0,0,1,137,11,14,5,7,3,3,3,21,8,13,25,11,14,0,9
"100 block jefferson st w, Syracuse, NY",15,4,9,5,1,4,1,0,0,0,0,0,3,10,5,0,0,0,0,0,42,4,2,3,5,1,0,0,14,6,8,1,1,0,0,4
"100 block john st, Syracuse, NY",179,17,15,11,153,17,13,0,1,2,0,0,1,123,35,5,9,0,4,3,388,107,29,11,12,8,3,9,26,4,22,153,35,118,5,12
"100 block kappesser st, Syracuse, NY",16,3,6,0,10,3,0,0,0,0,0,0,3,11,3,0,2,0,0,0,47,6,3,3,2,0,0,2,6,2,4,10,3,7,1,2
"100 block keen pl, Syracuse, NY",30,3,22,5,3,3,2,0,0,0,0,0,1,16,11,1,1,0,1,0,70,10,8,9,1,0,1,1,27,6,21,3,1,2,0,3
"100 block kellogg st, Syracuse, NY",8,13,0,1,7,13,0,0,0,0,0,0,13,5,3,0,0,0,0,0,19,2,3,2,0,1,0,0,1,0,1,7,5,2,1,12
"100 block kenmore av, Syracuse, NY",39,4,15,5,19,4,4,0,0,0,0,0,0,11,23,2,0,0,0,3,100,9,12,9,5,4,0,0,20,6,14,19,11,8,0,4
"100 block kennedy st e, Syracuse, NY",45,5,20,4,21,5,2,0,2,0,0,0,1,16,27,0,0,0,1,1,111,12,17,7,3,5,0,1,24,8,16,21,11,10,0,5
"100 block kensington rd, Syracuse, NY",0,0,0,0,0,0,0,0,0,0,0,0,0,0,0,0,0,0,0,0,0,0,0,0,0,0,0,0,0,0,0,0,0,0,0,0
"100 block kenwood av, Syracuse, NY",68,1,44,21,3,1,0,0,0,0,1,0,0,64,3,1,0,0,0,0,139,30,21,6,7,3,1,0,65,14,51,3,2,1,0,1
"100 block kimber av, Syracuse, NY",147,5,69,35,43,5,0,0,1,0,0,0,4,102,42,0,0,0,1,2,305,61,41,29,8,5,3,0,104,24,80,43,14,29,0,5
"100 block kuhl av, Syracuse, NY",60,8,34,7,19,8,0,0,1,0,0,0,7,49,5,2,0,0,3,1,159,16,19,9,8,4,3,1,41,12,29,19,8,11,0,8
"100 block lafayette av e, Syracuse, NY",11,2,7,0,4,2,0,0,1,0,0,0,1,7,3,1,0,0,0,0,27,4,2,2,2,1,0,0,7,2,5,4,1,3,0,2
"100 block lafayette av w, Syracuse, NY",227,11,45,16,166,11,3,0,1,0,0,0,7,91,121,7,0,0,4,4,402,140,42,23,8,9,3,2,61,17,44,166,20,146,0,11
"100 block lafayette rd, Syracuse, NY",0,0,0,0,0,0,0,0,0,0,0,0,0,0,0,0,0,0,0,0,0,0,0,0,0,0,0,0,0,0,0,0,0,0,0,0
"100 block lafayette st w, Syracuse, NY",143,14,53,13,77,14,8,0,2,0,0,0,4,50,88,2,0,0,1,2,363,28,61,25,13,11,4,1,66,23,43,77,55,22,1,13
"100 block lakeview av, Syracuse, NY",0,4,0,0,0,4,2,0,0,0,0,0,2,0,0,0,0,0,0,0,0,0,0,0,0,0,0,0,0,0,0,0,0,0,0,4
"100 block latimer ter, Syracuse, NY",0,0,0,0,0,0,0,0,0,0,0,0,0,0,0,0,0,0,0,0,0,0,0,0,0,0,0,0,0,0,0,0,0,0,0,0
"100 block leavenworth av, Syracuse, NY",0,0,0,0,0,0,0,0,0,0,0,0,0,0,0,0,0,0,0,0,0,0,0,0,0,0,0,0,0,0,0,0,0,0,0,0
"100 block lewis st, Syracuse, NY",0,0,0,0,0,0,0,0,0,0,0,0,0,0,0,0,0,0,0,0,0,0,0,0,0,0,0,0,0,0,0,0,0,0,0,0
"100 block light ct, Syracuse, NY",1,0,0,1,0,0,0,0,0,0,0,0,0,0,1,0,0,0,0,0,6,0,0,0,0,0,1,0,1,1,0,0,0,0,0,0
"100 block lincoln av, Syracuse, NY",6,3,1,3,2,3,0,0,0,0,0,0,3,2,4,0,0,0,0,0,11,3,1,2,0,0,0,0,4,0,4,2,1,1,0,3
"100 block linwill terrace, Syracuse, NY",1623,116,384,175,1064,116,65,4,10,4,5,0,28,1196,325,16,22,0,23,41,3203,734,501,212,97,48,23,8,559,109,450,1064,283,781,4,112
"100 block lodi st, Syracuse, NY",0,0,0,0,0,0,0,0,0,0,0,0,0,0,0,0,0,0,0,0,0,0,0,0,0,0,0,0,0,0,0,0,0,0,0,0
"100 block loehr av, Syracuse, NY",0,0,0,0,0,0,0,0,0,0,0,0,0,0,0,0,0,0,0,0,0,0,0,0,0,0,0,0,0,0,0,0,0,0,0,0
"100 block loma av, Syracuse, NY",54,6,21,14,19,6,0,1,1,0,0,0,4,46,6,0,0,0,0,2,109,19,22,7,5,1,0,0,35,6,29,19,4,15,1,5
"100 block lorraine av n, Syracuse, NY",51,6,40,11,0,6,0,0,2,3,1,0,0,47,4,0,0,0,0,0,126,13,20,7,6,3,1,1,51,15,36,0,0,0,0,6
"100 block lowell av n, Syracuse, NY",24,5,4,1,19,5,0,0,0,0,0,0,5,24,0,0,0,0,0,0,32,17,6,1,0,0,0,0,5,0,5,19,0,19,1,4
"100 block lowell av s, Syracuse, NY",0,0,0,0,0,0,0,0,0,0,0,0,0,0,0,0,0,0,0,0,0,0,0,0,0,0,0,0,0,0,0,0,0,0,0,0
"100 block luddington st, Syracuse, NY",23,1,9,11,3,1,0,0,1,0,0,0,0,20,1,0,0,0,2,0,42,8,11,4,0,0,0,0,20,1,19,3,0,3,0,1
"100 block madison st, Syracuse, NY",29,1,20,7,2,1,0,0,0,0,1,0,0,25,1,0,3,0,0,0,35,23,6,0,0,0,0,0,27,0,27,2,0,2,0,1
"100 block mains av, Syracuse, NY",28,2,19,4,5,2,0,0,1,0,0,0,1,18,9,1,0,0,0,0,78,8,9,4,2,1,2,2,23,7,16,5,2,3,0,2
"100 block manilla st, Syracuse, NY",0,0,0,0,0,0,0,0,0,0,0,0,0,0,0,0,0,0,0,0,0,0,0,0,0,0,0,0,0,0,0,0,0,0,0,0
"100 block manor dr, Syracuse, NY",30,1,17,12,1,1,0,0,1,0,0,0,0,21,7,0,1,0,0,1,56,12,13,2,3,0,0,0,29,4,25,1,0,1,0,1
"100 block maple ter, Syracuse, NY",0,0,0,0,0,0,0,0,0,0,0,0,0,0,0,0,0,0,0,0,0,0,0,0,0,0,0,0,0,0,0,0,0,0,0,0
"100 block maplewood av, Syracuse, NY",104,5,63,27,14,5,0,0,1,0,0,0,4,79,17,6,0,0,0,2,235,36,36,14,9,7,1,1,90,24,66,14,4,10,0,5
"100 block marshall st, Syracuse, NY",67,0,0,0,67,0,0,0,0,0,0,0,0,23,3,0,39,0,1,1,68,66,1,0,0,0,0,0,0,0,0,67,0,67,0,0
"100 block martin luther king  w, Syracuse, NY",0,0,0,0,0,0,0,0,0,0,0,0,0,0,0,0,0,0,0,0,0,0,0,0,0,0,0,0,0,0,0,0,0,0,0,0
"100 block mather st, Syracuse, NY",0,0,0,0,0,0,0,0,0,0,0,0,0,0,0,0,0,0,0,0,0,0,0,0,0,0,0,0,0,0,0,0,0,0,0,0
"100 block matson av w, Syracuse, NY",0,0,0,0,0,0,0,0,0,0,0,0,0,0,0,0,0,0,0,0,0,0,0,0,0,0,0,0,0,0,0,0,0,0,0,0
"100 block maxwell av, Syracuse, NY",25,0,9,1,15,0,0,0,0,0,0,0,0,9,16,0,0,0,0,0,60,8,6,6,4,0,1,0,10,2,8,15,9,6,0,0
"100 block mayar st, Syracuse, NY",31,1,16,13,2,1,0,0,0,0,0,0,1,28,0,1,2,0,0,0,60,13,12,3,1,2,0,0,29,2,27,2,0,2,0,1
"100 block mcclure av, Syracuse, NY",12,1,5,2,5,1,1,0,0,0,0,0,0,0,11,0,0,0,0,1,40,2,1,5,1,2,0,1,7,4,3,5,5,0,0,1
"100 block mclennan av, Syracuse, NY",11,1,1,2,8,1,0,0,0,0,0,0,1,0,7,0,0,0,1,3,29,4,3,0,2,1,1,0,3,1,2,8,5,3,0,1
"100 block meadowbrook dr, Syracuse, NY",1,0,0,0,1,0,0,0,0,0,0,0,0,0,0,0,1,0,0,0,2,0,1,0,0,0,0,0,0,0,0,1,0,1,0,0
"100 block melbourne av, Syracuse, NY",11,2,0,0,11,2,2,0,0,0,0,0,0,7,4,0,0,0,0,0,17,6,4,1,0,0,0,0,0,0,0,11,2,9,0,2
"100 block merrill st, Syracuse, NY",159,15,74,30,55,15,6,0,1,0,1,0,7,142,10,1,1,0,3,2,341,58,56,25,11,4,4,1,104,17,87,55,16,39,0,15
"100 block merriman av, Syracuse, NY",0,0,0,0,0,0,0,0,0,0,0,0,0,0,0,0,0,0,0,0,0,0,0,0,0,0,0,0,0,0,0,0,0,0,0,0
"100 block michaels av, Syracuse, NY",94,12,12,10,72,12,7,1,0,0,0,0,4,70,19,1,2,0,0,2,206,41,24,10,13,3,1,2,22,5,17,72,23,49,1,11
"100 block midler av n, Syracuse, NY",42,0,19,5,18,0,0,0,0,0,0,0,0,36,1,3,1,0,1,0,106,15,10,4,8,3,2,0,24,11,13,18,5,13,0,0
"100 block milburn dr, Syracuse, NY",44,1,27,14,3,1,0,0,1,0,0,0,0,33,9,0,0,0,0,2,107,16,15,1,7,2,1,2,41,9,32,3,0,3,0,1
"100 block mildred av, Syracuse, NY",3,1,0,0,3,1,1,0,0,0,0,0,0,3,0,0,0,0,0,0,6,0,3,0,0,0,0,0,0,0,0,3,0,3,0,1
"100 block miles av, Syracuse, NY",65,1,27,6,32,1,0,0,0,0,0,0,1,54,8,0,2,0,0,1,162,23,17,8,10,4,1,2,33,7,26,32,7,25,0,1
"100 block milford ct, Syracuse, NY",89,1,50,24,15,1,0,0,0,0,0,0,1,85,3,0,0,0,0,1,182,36,30,11,8,3,1,0,74,12,62,15,2,13,0,1
"100 block monroe st, Syracuse, NY",52,0,0,1,51,0,0,0,0,0,0,0,0,5,44,0,0,0,2,1,109,20,15,11,5,0,1,0,1,0,1,51,29,22,0,0
"100 block montgomery st, Syracuse, NY",2,2,0,0,2,2,2,0,0,0,0,0,0,0,0,0,1,0,0,1,4,1,0,1,0,0,0,0,0,0,0,2,1,1,0,2
"100 block monticello dr, Syracuse, NY",37,2,25,9,3,2,0,1,0,0,1,0,0,30,7,0,0,0,0,0,101,11,9,6,5,3,2,1,34,8,26,3,2,1,1,1
"100 block mosley dr, Syracuse, NY",75,9,35,12,28,9,2,0,0,0,0,4,3,60,5,1,2,0,3,4,158,30,20,16,5,4,0,0,47,12,35,28,12,16,0,9
"100 block murray av, Syracuse, NY",74,7,14,2,58,7,2,0,1,0,1,0,3,35,25,3,3,0,3,5,205,10,27,19,11,4,2,1,16,5,11,58,34,24,1,6
"100 block nelson st, Syracuse, NY",0,0,0,0,0,0,0,0,0,0,0,0,0,0,0,0,0,0,0,0,0,0,0,0,0,0,0,0,0,0,0,0,0,0,0,0
"100 block new st, Syracuse, NY",0,0,0,0,0,0,0,0,0,0,0,0,0,0,0,0,0,0,0,0,0,0,0,0,0,0,0,0,0,0,0,0,0,0,0,0
"100 block newbury hollow ln, Syracuse, NY",17,0,12,4,1,0,0,0,0,0,0,0,0,13,3,0,0,0,0,1,37,6,6,3,1,0,1,0,16,4,12,1,0,1,0,0
"100 block newell st w, Syracuse, NY",290,41,49,16,225,41,29,0,3,0,1,0,8,123,117,1,34,0,7,8,757,82,80,46,50,20,9,3,65,17,48,225,105,120,0,41
"100 block nichols av, Syracuse, NY",112,13,29,12,71,13,7,0,0,0,1,0,5,88,19,1,2,0,1,1,236,46,37,12,8,6,3,0,41,11,30,71,17,54,0,13
"100 block niven st, Syracuse, NY",44,3,32,11,1,3,0,0,1,1,1,0,0,39,3,1,0,0,1,0,109,9,19,6,7,2,1,0,43,13,30,1,0,1,0,3
"100 block normanor dr, Syracuse, NY",26,0,16,8,2,0,0,0,0,0,0,0,0,25,1,0,0,0,0,0,53,9,11,3,2,1,0,0,24,3,21,2,1,1,0,0
"100 block oak st, Syracuse, NY",21,8,1,3,17,8,2,0,5,0,0,0,1,18,2,0,0,0,1,0,41,9,6,5,0,1,0,0,4,0,4,17,4,13,0,8
"100 block onondaga st w, Syracuse, NY",3,0,0,0,3,0,0,0,0,0,0,0,0,3,0,0,0,0,0,0,3,3,0,0,0,0,0,0,0,0,0,3,0,3,0,0
"100 block onondaga st, Syracuse, NY",15,0,0,0,15,0,0,0,0,0,0,0,0,15,0,0,0,0,0,0,22,9,5,1,0,0,0,0,0,0,0,15,0,15,0,0
"100 block otisco st, Syracuse, NY",236,88,11,1,224,88,82,0,1,4,0,0,1,95,119,4,0,0,6,12,292,192,36,5,2,1,0,0,12,1,11,224,22,202,2,86
"100 block park av, Syracuse, NY",9,2,2,1,6,2,0,0,0,0,0,0,2,4,1,0,2,0,0,2,21,3,1,4,1,0,0,0,3,2,1,6,4,2,0,2
"100 block parkside av, Syracuse, NY",70,18,16,10,44,18,6,0,0,2,0,0,10,17,49,1,0,0,1,2,208,14,18,14,13,6,2,3,26,5,21,44,29,15,0,18
"100 block parkway dr, Syracuse, NY",0,0,0,0,0,0,0,0,0,0,0,0,0,0,0,0,0,0,0,0,0,0,0,0,0,0,0,0,0,0,0,0,0,0,0,0
"100 block peters st, Syracuse, NY",63,14,10,8,45,14,4,0,2,0,0,0,8,28,18,1,12,0,2,2,208,9,17,12,12,6,1,6,18,7,11,45,30,15,0,14
"100 block phillips rd, Syracuse, NY",12,0,6,5,1,0,0,0,0,0,0,0,0,6,5,0,1,0,0,0,29,5,3,0,2,2,0,0,11,4,7,1,0,1,0,0
"100 block plum st, Syracuse, NY",33,13,5,3,25,13,2,0,0,1,0,0,10,16,12,2,0,0,0,3,74,16,5,4,6,1,0,1,8,4,4,25,8,17,0,13
"100 block polk st, Syracuse, NY",24,3,19,5,0,3,0,0,1,0,0,0,2,11,11,0,1,0,0,1,49,10,7,5,1,0,1,0,24,7,17,0,0,0,0,3
"100 block pond st, Syracuse, NY",55,13,6,1,48,13,2,1,0,0,0,0,10,28,15,1,4,0,2,5,174,16,12,6,10,5,2,4,7,3,4,48,21,27,0,13
"100 block putnam st, Syracuse, NY",70,69,24,5,41,69,7,0,44,0,0,0,18,22,34,0,0,0,11,3,230,11,18,11,11,10,8,1,29,13,16,41,23,18,0,69
"100 block radisson ct, Syracuse, NY",0,0,0,0,0,0,0,0,0,0,0,0,0,0,0,0,0,0,0,0,0,0,0,0,0,0,0,0,0,0,0,0,0,0,0,0
"100 block redfield pl, Syracuse, NY",0,0,0,0,0,0,0,0,0,0,0,0,0,0,0,0,0,0,0,0,0,0,0,0,0,0,0,0,0,0,0,0,0,0,0,0
"100 block reed av, Syracuse, NY",41,5,16,1,24,5,3,0,0,1,1,0,0,26,12,0,1,0,2,0,114,8,15,6,5,4,3,0,17,5,12,24,9,15,0,5
"100 block remington av, Syracuse, NY",45,3,36,7,2,3,0,0,3,0,0,0,0,37,7,0,1,0,0,0,96,12,22,6,4,0,1,0,43,5,38,2,2,0,0,3
"100 block riverdale dr, Syracuse, NY",82,3,10,4,68,3,3,0,0,0,0,0,0,29,45,1,1,0,2,4,175,26,31,16,6,3,0,0,14,2,12,68,33,35,0,3
"100 block roberts av, Syracuse, NY",20,5,15,3,2,5,0,0,0,3,0,0,2,14,6,0,0,0,0,0,76,2,3,5,4,3,0,3,18,9,9,2,2,0,0,5
"100 block robinson st, Syracuse, NY",112,3,23,9,80,3,2,0,1,0,0,0,0,55,38,4,3,0,2,10,329,34,30,11,13,8,7,9,32,8,24,80,40,40,0,3
"100 block roney ln, Syracuse, NY",35,31,2,4,29,31,0,0,0,0,0,0,31,5,27,0,0,0,2,1,74,18,7,3,3,3,1,0,6,1,5,29,10,19,0,31
"100 block roosevelt av, Syracuse, NY",10,1,9,1,0,1,0,0,0,0,0,0,1,9,1,0,0,0,0,0,22,4,3,1,1,1,0,0,10,3,7,0,0,0,0,1
"100 block rosemont dr, Syracuse, NY",39,4,23,7,9,4,1,0,0,1,0,0,2,23,9,6,1,0,0,0,105,12,7,7,8,4,1,0,30,9,21,9,5,4,0,4
"100 block ross park dr, Syracuse, NY",77,8,23,20,34,8,4,0,2,0,0,0,2,62,10,2,2,0,1,0,200,26,22,9,10,4,3,3,43,7,36,34,20,14,3,5
"100 block ross pk, Syracuse, NY",79,5,37,18,24,5,1,0,2,0,0,0,2,66,9,0,3,0,0,1,187,27,23,13,10,3,2,1,55,15,40,24,8,16,0,5
"100 block rugby rd, Syracuse, NY",115,6,73,30,12,6,1,0,2,1,0,0,2,108,3,1,0,0,0,3,269,30,43,23,13,4,2,0,103,23,80,12,2,10,0,6
"100 block russell pl, Syracuse, NY",18,0,15,3,0,0,0,0,0,0,0,0,0,17,0,0,0,0,0,1,54,2,6,5,2,2,0,1,18,8,10,0,0,0,0,0
"100 block sabine st, Syracuse, NY",149,37,19,7,123,37,17,0,5,0,0,0,15,69,57,1,0,0,16,6,370,44,47,27,20,5,1,5,26,6,20,123,40,83,3,34
"100 block schneider st, Syracuse, NY",101,11,21,14,66,11,9,0,1,0,0,0,1,69,22,1,3,1,3,2,272,28,29,18,9,10,5,2,35,8,27,66,30,36,0,11
"100 block schoeneck av, Syracuse, NY",0,0,0,0,0,0,0,0,0,0,0,0,0,0,0,0,0,0,0,0,0,0,0,0,0,0,0,0,0,0,0,0,0,0,0,0
"100 block schuler st, Syracuse, NY",0,0,0,0,0,0,0,0,0,0,0,0,0,0,0,0,0,0,0,0,0,0,0,0,0,0,0,0,0,0,0,0,0,0,0,0
"100 block searlwyn av, Syracuse, NY",12,0,8,4,0,0,0,0,0,0,0,0,0,10,2,0,0,0,0,0,23,4,5,3,0,0,0,0,12,3,9,0,0,0,0,0
"100 block second north st, Syracuse, NY",57,7,16,8,33,7,4,0,0,0,0,0,3,28,14,3,8,0,1,3,158,16,11,15,8,4,1,2,24,10,14,33,17,16,0,7
"100 block sedgewick rd, Syracuse, NY",65,7,17,7,41,7,3,1,0,0,0,0,3,48,7,1,6,0,2,1,144,22,23,10,5,4,1,0,24,5,19,41,11,30,0,7
"100 block sedgwick rd, Syracuse, NY",80,11,24,7,49,11,3,1,1,0,0,0,6,58,11,1,6,0,3,1,172,28,29,12,6,4,1,0,31,9,22,49,12,37,0,11
"100 block seeley av, Syracuse, NY",9,0,5,2,2,0,0,0,0,0,0,0,0,2,4,1,0,0,2,0,24,1,3,3,2,0,0,0,7,4,3,2,0,2,0,0
"100 block seneca dr, Syracuse, NY",15,0,8,4,3,0,0,0,0,0,0,0,0,10,5,0,0,0,0,0,33,2,9,3,1,0,0,0,12,3,9,3,0,3,0,0
"100 block seneca tpke e, Syracuse, NY",95,6,52,26,17,6,0,2,1,1,0,0,2,72,20,0,2,0,0,1,230,20,41,21,7,3,2,1,78,13,65,17,7,10,2,4
"100 block seneca tpke w, Syracuse, NY",793,44,32,29,732,44,33,1,4,0,2,0,4,406,127,4,222,0,14,20,1360,422,247,78,29,10,6,1,61,6,55,732,96,636,1,43
"100 block seventh north st, Syracuse, NY",38,3,18,10,10,3,0,0,0,0,1,0,2,35,2,0,1,0,0,0,90,11,14,6,4,1,2,0,28,4,24,10,3,7,0,3
"100 block seymour st, Syracuse, NY",0,0,0,0,0,0,0,0,0,0,0,0,0,0,0,0,0,0,0,0,0,0,0,0,0,0,0,0,0,0,0,0,0,0,0,0
"100 block shirley rd, Syracuse, NY",100,4,58,25,17,4,0,0,1,1,1,0,1,83,10,0,3,0,0,4,224,31,38,15,10,4,2,0,83,20,63,17,3,14,0,4
"100 block sidman av, Syracuse, NY",61,11,13,4,44,11,2,0,0,0,1,0,8,43,14,2,0,0,0,2,153,18,22,9,4,5,1,2,17,5,12,44,20,24,0,11
"100 block smith ln, Syracuse, NY",29,2,7,8,14,2,1,0,0,0,0,0,1,1,22,0,0,0,3,3,86,5,8,5,6,4,1,0,15,7,8,14,10,4,0,2
"100 block snell ter, Syracuse, NY",0,0,0,0,0,0,0,0,0,0,0,0,0,0,0,0,0,0,0,0,0,0,0,0,0,0,0,0,0,0,0,0,0,0,0,0
"100 block solar st, Syracuse, NY",10,0,3,2,5,0,0,0,0,0,0,0,0,9,1,0,0,0,0,0,24,4,3,2,0,0,0,1,5,1,4,5,1,4,0,0
"100 block south av, Syracuse, NY",37,5,5,11,21,5,0,2,0,0,0,0,3,6,28,0,0,0,2,1,96,10,9,10,3,4,1,0,16,8,8,21,10,11,0,5
"100 block spring st, Syracuse, NY",72,5,10,5,57,5,0,0,3,0,0,0,2,42,11,0,14,0,3,2,237,14,20,10,10,6,7,5,15,5,10,57,29,28,0,5
"100 block st anne dr, Syracuse, NY",24,5,8,6,10,5,0,0,3,0,0,0,2,14,3,1,0,0,5,1,66,6,7,2,7,1,0,1,14,2,12,10,9,1,0,5
"100 block st louis av, Syracuse, NY",73,4,32,9,32,4,2,0,0,0,0,0,2,32,35,0,1,0,3,2,190,17,29,6,12,7,0,2,41,13,28,32,14,18,1,3
"100 block steuben st, Syracuse, NY",133,19,17,12,104,19,2,0,1,0,0,0,16,79,25,5,13,0,6,5,448,30,26,21,22,14,9,11,29,13,16,104,53,51,1,18
"100 block stewart ct, Syracuse, NY",0,0,0,0,0,0,0,0,0,0,0,0,0,0,0,0,0,0,0,0,0,0,0,0,0,0,0,0,0,0,0,0,0,0,0,0
"100 block stinard av, Syracuse, NY",14,6,5,0,9,6,3,0,1,1,0,0,1,8,6,0,0,0,0,0,32,7,1,2,3,1,0,0,5,1,4,9,5,4,0,6
"100 block strathmore dr, Syracuse, NY",72,3,39,6,27,3,1,0,1,1,0,0,0,52,16,0,0,0,0,4,189,15,25,15,10,4,2,1,45,17,28,27,8,19,0,3
"100 block strong av, Syracuse, NY",14,1,11,3,0,1,0,0,0,0,0,0,1,10,3,0,0,0,1,0,31,4,5,3,2,0,0,0,14,3,11,0,0,0,0,1
"100 block sunrise dr, Syracuse, NY",1,0,0,0,1,0,0,0,0,0,0,0,0,1,0,0,0,0,0,0,3,0,0,1,0,0,0,0,0,0,0,1,1,0,0,0
"100 block sunset av, Syracuse, NY",0,0,0,0,0,0,0,0,0,0,0,0,0,0,0,0,0,0,0,0,0,0,0,0,0,0,0,0,0,0,0,0,0,0,0,0
"100 block sunstruck dr, Syracuse, NY",41,12,7,4,30,12,3,0,0,0,0,0,9,29,8,1,0,0,0,3,112,14,7,6,6,6,2,0,11,2,9,30,17,13,0,12
"100 block syracuse st, Syracuse, NY",82,30,11,8,63,30,7,0,6,0,0,0,17,61,14,3,0,0,2,2,220,31,16,13,7,4,7,4,19,4,15,63,28,35,0,30
"100 block temple pl, Syracuse, NY",39,8,9,9,21,8,3,0,0,0,0,0,5,12,23,1,0,0,0,3,125,9,8,5,4,11,0,2,18,5,13,21,13,8,0,8
"100 block tennyson av, Syracuse, NY",0,0,0,0,0,0,0,0,0,0,0,0,0,0,0,0,0,0,0,0,0,0,0,0,0,0,0,0,0,0,0,0,0,0,0,0
"100 block titus al, Syracuse, NY",0,0,0,0,0,0,0,0,0,0,0,0,0,0,0,0,0,0,0,0,0,0,0,0,0,0,0,0,0,0,0,0,0,0,0,0
"100 block townsend pl n, Syracuse, NY",3,0,0,0,3,0,0,0,0,0,0,0,0,3,0,0,0,0,0,0,5,1,2,0,0,0,0,0,0,0,0,3,0,3,0,0
"100 block townsend pl, Syracuse, NY",16,10,3,0,13,10,6,0,0,0,0,0,4,5,5,0,5,0,0,1,78,2,2,0,2,6,1,3,3,0,3,13,12,1,0,10
"100 block tracy st, Syracuse, NY",0,0,0,0,0,0,0,0,0,0,0,0,0,0,0,0,0,0,0,0,0,0,0,0,0,0,0,0,0,0,0,0,0,0,0,0
"100 block trinity pl, Syracuse, NY",27,0,12,3,12,0,0,0,0,0,0,0,0,14,9,1,0,0,2,1,82,5,7,6,3,3,3,0,15,5,10,12,7,5,0,0
"100 block vale st, Syracuse, NY",49,13,26,8,15,13,4,0,0,0,0,0,9,8,37,0,3,0,1,0,146,8,15,9,9,4,3,1,34,13,21,15,13,2,1,12
"100 block valley dr, Syracuse, NY",13,8,1,0,12,8,1,0,1,0,0,0,6,4,9,0,0,0,0,0,47,2,3,1,2,3,1,1,1,1,0,12,8,4,1,7
"100 block van rensselaer st, Syracuse, NY",0,0,0,0,0,0,0,0,0,0,0,0,0,0,0,0,0,0,0,0,0,0,0,0,0,0,0,0,0,0,0,0,0,0,0,0
"100 block vann st, Syracuse, NY",24,4,10,5,9,4,0,0,1,0,0,0,3,20,4,0,0,0,0,0,65,5,8,6,2,2,0,1,15,5,10,9,2,7,0,4
"100 block victoria pl, Syracuse, NY",110,3,32,12,66,3,0,0,0,0,0,0,3,95,7,0,5,0,0,3,258,36,28,31,10,1,2,2,44,12,32,66,13,53,0,3
"100 block vincent st, Syracuse, NY",14,1,11,1,2,1,1,0,0,0,0,0,0,10,4,0,0,0,0,0,33,4,5,3,1,0,1,0,12,4,8,2,0,2,0,1
"100 block wadsworth st, Syracuse, NY",53,4,26,10,17,4,0,0,2,0,0,0,2,47,2,0,1,0,3,0,133,15,17,10,7,1,2,1,36,10,26,17,9,8,0,4
"100 block wall st, Syracuse, NY",0,0,0,0,0,0,0,0,0,0,0,0,0,0,0,0,0,0,0,0,0,0,0,0,0,0,0,0,0,0,0,0,0,0,0,0
"100 block walrath rd, Syracuse, NY",66,9,35,9,22,9,3,0,2,0,0,0,4,14,47,0,0,0,2,3,173,20,19,7,13,4,2,1,44,10,34,22,14,8,0,9
"100 block walton st, Syracuse, NY",0,0,0,0,0,0,0,0,0,0,0,0,0,0,0,0,0,0,0,0,0,0,0,0,0,0,0,0,0,0,0,0,0,0,0,0
"100 block warham st, Syracuse, NY",33,3,11,5,17,3,2,0,0,0,0,0,1,16,8,0,8,0,0,1,93,9,9,5,3,4,2,1,16,10,6,17,4,13,0,3
"100 block warrington av e, Syracuse, NY",47,3,30,10,7,3,1,0,0,1,0,0,1,33,11,1,0,0,0,2,122,8,20,10,3,4,2,0,40,11,29,7,2,5,0,3
"100 block washington sq, Syracuse, NY",0,0,0,0,0,0,0,0,0,0,0,0,0,0,0,0,0,0,0,0,0,0,0,0,0,0,0,0,0,0,0,0,0,0,0,0
"100 block washington st e, Syracuse, NY",0,0,0,0,0,0,0,0,0,0,0,0,0,0,0,0,0,0,0,0,0,0,0,0,0,0,0,0,0,0,0,0,0,0,0,0
"100 block washington st w, Syracuse, NY",0,0,0,0,0,0,0,0,0,0,0,0,0,0,0,0,0,0,0,0,0,0,0,0,0,0,0,0,0,0,0,0,0,0,0,0
"100 block water st e, Syracuse, NY",0,0,0,0,0,0,0,0,0,0,0,0,0,0,0,0,0,0,0,0,0,0,0,0,0,0,0,0,0,0,0,0,0,0,0,0
"100 block wayne st, Syracuse, NY",0,0,0,0,0,0,0,0,0,0,0,0,0,0,0,0,0,0,0,0,0,0,0,0,0,0,0,0,0,0,0,0,0,0,0,0
"100 block weiser ct, Syracuse, NY",171,10,0,0,171,10,9,1,0,0,0,0,0,32,126,3,2,0,5,3,189,158,10,1,2,0,0,0,0,0,0,171,8,163,0,10
"100 block wellesley rd, Syracuse, NY",160,16,84,40,36,16,8,0,1,0,1,0,6,108,42,1,0,0,2,7,411,46,45,25,29,8,5,2,124,36,88,36,23,13,0,16
"100 block wendell ter, Syracuse, NY",0,0,0,0,0,0,0,0,0,0,0,0,0,0,0,0,0,0,0,0,0,0,0,0,0,0,0,0,0,0,0,0,0,0,0,0
"100 block westminster av, Syracuse, NY",174,3,16,15,143,3,1,0,0,1,0,0,1,148,3,2,13,0,3,5,547,19,40,57,28,22,3,5,31,8,23,143,0,143,0,3
"100 block white st, Syracuse, NY",6,0,1,0,5,0,0,0,0,0,0,0,0,1,5,0,0,0,0,0,14,3,0,1,2,0,0,0,1,0,1,5,1,4,0,0
"100 block wilbur av n, Syracuse, NY",111,31,19,11,81,31,22,0,2,4,0,0,3,102,1,1,3,0,0,4,213,54,26,23,4,2,2,0,30,1,29,81,10,71,0,31
"100 block willis av, Syracuse, NY",76,9,19,9,48,9,7,0,0,1,0,0,1,72,2,2,0,0,0,0,138,37,24,10,3,1,1,0,28,5,23,48,8,40,0,9
"100 block wolf st, Syracuse, NY",0,0,0,0,0,0,0,0,0,0,0,0,0,0,0,0,0,0,0,0,0,0,0,0,0,0,0,0,0,0,0,0,0,0,0,0
"100 block xavier cir, Syracuse, NY",1,0,0,0,1,0,0,0,0,0,0,0,0,0,0,0,1,0,0,0,3,0,0,1,0,0,0,0,0,0,0,1,1,0,0,0
"1000 block adams st e, Syracuse, NY",166,45,48,13,105,45,24,0,1,0,0,0,20,137,22,2,0,0,3,2,404,54,45,35,16,8,5,3,61,13,48,105,36,69,1,44
"1000 block avery av, Syracuse, NY",140,31,30,29,81,31,11,0,4,2,1,0,13,124,6,4,0,0,3,3,316,55,39,24,12,5,2,3,59,11,48,81,30,51,0,31
"1000 block bellevue av, Syracuse, NY",120,15,43,22,55,15,2,0,4,3,0,0,6,60,48,0,2,0,6,4,319,25,39,26,17,9,3,1,65,22,43,55,25,30,0,15
"1000 block canal st, Syracuse, NY",77,10,10,8,59,10,6,0,0,0,0,0,4,37,32,3,0,0,1,4,222,19,21,11,12,9,1,4,18,5,13,59,29,30,0,10
"1000 block carbon st, Syracuse, NY",20,2,0,0,20,2,2,0,0,0,0,0,0,15,3,0,1,0,0,1,62,6,5,2,0,5,1,1,0,0,0,20,8,12,0,2
"1000 block clinton st s, Syracuse, NY",105,34,10,13,82,34,25,0,1,0,0,0,8,71,24,1,0,0,4,5,267,32,35,14,7,10,6,1,23,2,21,82,31,51,0,34
"1000 block court st, Syracuse, NY",46,3,22,11,13,3,0,0,0,0,0,0,3,41,2,0,1,0,0,2,100,17,20,4,1,1,1,2,33,5,28,13,5,8,0,3
"1000 block danforth st, Syracuse, NY",109,7,13,16,80,7,2,0,0,0,1,0,4,87,11,3,5,0,1,2,222,45,35,17,6,5,0,1,29,7,22,80,18,62,0,7
"1000 block emerson av, Syracuse, NY",0,0,0,0,0,0,0,0,0,0,0,0,0,0,0,0,0,0,0,0,0,0,0,0,0,0,0,0,0,0,0,0,0,0,0,0
"1000 block erie blvd e, Syracuse, NY",41,6,5,7,29,6,5,0,0,0,0,0,1,24,9,1,3,0,1,3,121,8,16,4,5,5,0,3,12,4,8,29,12,17,0,6
"1000 block fayette st e, Syracuse, NY",0,0,0,0,0,0,0,0,0,0,0,0,0,0,0,0,0,0,0,0,0,0,0,0,0,0,0,0,0,0,0,0,0,0,0,0
"1000 block fayette st w, Syracuse, NY",31,10,9,3,19,10,4,0,0,1,2,0,3,8,9,0,0,0,10,4,77,15,5,2,4,3,1,1,12,7,5,19,5,14,1,9
"1000 block first north st, Syracuse, NY",120,16,30,14,76,16,9,0,2,0,1,0,4,88,16,1,6,0,1,8,262,50,30,23,9,6,1,1,44,13,31,76,22,54,0,16
"1000 block genesee st e, Syracuse, NY",0,0,0,0,0,0,0,0,0,0,0,0,0,0,0,0,0,0,0,0,0,0,0,0,0,0,0,0,0,0,0,0,0,0,0,0
"1000 block genesee st w, Syracuse, NY",0,0,0,0,0,0,0,0,0,0,0,0,0,0,0,0,0,0,0,0,0,0,0,0,0,0,0,0,0,0,0,0,0,0,0,0
"1000 block genessee st w, Syracuse, NY",0,0,0,0,0,0,0,0,0,0,0,0,0,0,0,0,0,0,0,0,0,0,0,0,0,0,0,0,0,0,0,0,0,0,0,0
"1000 block harrison st, Syracuse, NY",85,1,0,0,85,1,1,0,0,0,0,0,0,71,3,0,7,0,2,2,215,25,20,21,11,5,3,0,0,0,0,85,1,84,0,1
"1000 block highland av, Syracuse, NY",25,5,1,3,21,5,0,1,0,0,0,0,4,15,2,0,7,0,0,1,87,5,5,3,3,5,3,1,4,1,3,21,15,6,0,5
"1000 block highland st, Syracuse, NY",50,8,9,12,29,8,2,1,1,0,0,0,4,35,4,0,8,0,1,2,155,12,12,9,6,5,3,3,21,8,13,29,17,12,0,8
"1000 block irving av, Syracuse, NY",22,2,4,6,12,2,0,0,0,0,0,0,2,0,22,0,0,0,0,0,66,7,5,1,6,0,2,1,10,3,7,12,6,6,0,2
"1000 block ivy ridge rd, Syracuse, NY",0,0,0,0,0,0,0,0,0,0,0,0,0,0,0,0,0,0,0,0,0,0,0,0,0,0,0,0,0,0,0,0,0,0,0,0
"1000 block lancaster av, Syracuse, NY",0,0,0,0,0,0,0,0,0,0,0,0,0,0,0,0,0,0,0,0,0,0,0,0,0,0,0,0,0,0,0,0,0,0,0,0
"1000 block madison st, Syracuse, NY",27,1,0,1,26,1,0,0,0,0,0,0,1,19,4,0,4,0,0,0,44,15,8,3,1,0,0,0,1,0,1,26,1,25,0,1
"1000 block mcbride st s, Syracuse, NY",0,1,0,0,0,1,0,0,0,0,0,0,1,0,0,0,0,0,0,0,0,0,0,0,0,0,0,0,0,0,0,0,0,0,0,1
"1000 block meadowbrook dr, Syracuse, NY",33,1,10,3,20,1,0,0,0,0,0,0,1,28,2,1,0,0,2,0,75,10,10,9,2,2,0,0,13,6,7,20,3,17,1,0
"1000 block midland av, Syracuse, NY",36,12,13,11,12,12,1,0,0,0,0,0,11,6,28,0,0,0,0,2,113,8,7,7,6,6,0,2,24,7,17,12,10,2,0,12
"1000 block milton av, Syracuse, NY",22,0,11,3,8,0,0,0,0,0,0,0,0,20,1,0,0,0,1,0,48,8,8,2,2,2,0,0,14,1,13,8,4,4,0,0
"1000 block oak st, Syracuse, NY",17,4,8,3,6,4,0,1,3,0,0,0,0,16,1,0,0,0,0,0,39,6,5,3,2,0,1,0,11,3,8,6,0,6,0,4
"1000 block park st, Syracuse, NY",45,6,3,4,38,6,2,0,0,0,2,0,2,32,9,1,1,0,1,1,104,23,5,6,7,2,0,2,7,4,3,38,14,24,0,6
"1000 block pond st, Syracuse, NY",131,6,38,15,78,6,2,0,0,0,0,0,4,107,13,4,2,0,2,3,294,54,35,17,12,10,1,2,53,14,39,78,21,57,0,6
"1000 block salina st s, Syracuse, NY",83,1,0,0,83,1,1,0,0,0,0,0,0,0,70,1,0,0,4,8,453,2,10,14,11,8,10,28,0,0,0,83,71,12,0,1
"1000 block state st n, Syracuse, NY",66,8,40,16,10,8,1,0,1,1,2,0,3,58,1,1,3,0,0,3,104,34,27,4,1,0,0,0,56,3,53,10,1,9,0,8
"1000 block teall av, Syracuse, NY",0,0,0,0,0,0,0,0,0,0,0,0,0,0,0,0,0,0,0,0,0,0,0,0,0,0,0,0,0,0,0,0,0,0,0,0
"1000 block tyson pl, Syracuse, NY",24,0,10,12,2,0,0,0,0,0,0,0,0,24,0,0,0,0,0,0,52,4,14,4,2,0,0,0,22,3,19,2,0,2,0,0
"1000 block union pl, Syracuse, NY",0,0,0,0,0,0,0,0,0,0,0,0,0,0,0,0,0,0,0,0,0,0,0,0,0,0,0,0,0,0,0,0,0,0,0,0
"1000 block wadsworth st, Syracuse, NY",173,9,50,28,95,9,2,0,1,1,2,0,3,82,71,2,3,0,4,11,609,40,51,22,14,8,10,28,78,6,72,95,72,23,0,9
"1000 block walnut av, Syracuse, NY",136,0,0,0,136,0,0,0,0,0,0,0,0,85,4,0,44,0,1,2,284,71,15,27,13,10,0,0,0,0,0,136,2,134,0,0
"1000 block westcott st, Syracuse, NY",16,0,6,4,6,0,0,0,0,0,0,0,0,16,0,0,0,0,0,0,34,5,6,3,2,0,0,0,10,5,5,6,1,5,0,0
"1000 block westmoreland av, Syracuse, NY",152,0,6,4,142,0,0,0,0,0,0,0,0,101,4,0,44,0,1,2,318,76,21,30,15,10,0,0,10,5,5,142,3,139,0,0
"1000 block willis av, Syracuse, NY",0,0,0,0,0,0,0,0,0,0,0,0,0,0,0,0,0,0,0,0,0,0,0,0,0,0,0,0,0,0,0,0,0,0,0,0
"1000 block wolf st, Syracuse, NY",434,50,162,102,170,50,14,6,4,0,0,0,26,340,42,2,40,0,4,6,1048,128,158,64,34,32,14,4,264,50,214,170,82,88,0,50
"1100 block avery av, Syracuse, NY",0,0,0,0,0,0,0,0,0,0,0,0,0,0,0,0,0,0,0,0,0,0,0,0,0,0,0,0,0,0,0,0,0,0,0,0
"1100 block ballantyne rd, Syracuse, NY",434,50,162,102,170,50,14,6,4,0,0,0,26,340,42,2,40,0,4,6,1048,128,158,64,34,32,14,4,264,50,214,170,82,88,0,50
"1100 block bellevue av, Syracuse, NY",25,4,6,2,17,4,2,0,0,1,0,0,1,15,7,0,0,0,1,2,95,3,4,6,4,5,0,3,8,4,4,17,14,3,0,4
"1100 block carbon st, Syracuse, NY",32,2,9,1,22,2,1,0,0,0,0,0,1,27,3,0,2,0,0,0,77,11,11,4,2,0,4,0,10,4,6,22,5,17,0,2
"1100 block erie blvd e, Syracuse, NY",126,11,8,3,115,11,3,0,0,0,0,0,8,81,14,2,19,0,7,3,381,23,33,21,29,10,8,2,11,4,7,115,60,55,1,10
"1100 block erie blvd w, Syracuse, NY",126,11,8,3,115,11,3,0,0,0,0,0,8,81,14,2,19,0,7,3,381,23,33,21,29,10,8,2,11,4,7,115,60,55,1,10
"1100 block fayette st e, Syracuse, NY",54,6,0,1,53,6,3,1,0,0,0,0,2,39,6,0,7,0,0,2,96,28,13,11,1,1,0,0,1,0,1,53,0,53,0,6
"1100 block geddes st s, Syracuse, NY",67,11,7,7,53,11,3,7,0,1,0,0,0,23,28,1,0,0,11,4,216,15,10,15,15,5,4,3,14,7,7,53,32,21,0,11
"1100 block genesee st e, Syracuse, NY",0,0,0,0,0,0,0,0,0,0,0,0,0,0,0,0,0,0,0,0,0,0,0,0,0,0,0,0,0,0,0,0,0,0,0,0
"1100 block genesee st w, Syracuse, NY",0,0,0,0,0,0,0,0,0,0,0,0,0,0,0,0,0,0,0,0,0,0,0,0,0,0,0,0,0,0,0,0,0,0,0,0
"1100 block grant blvd, Syracuse, NY",18,2,4,3,11,2,0,1,0,1,0,0,0,16,2,0,0,0,0,0,33,7,7,4,0,0,0,0,7,2,5,11,2,9,0,2
"1100 block kirkpatrick st, Syracuse, NY",37,1,17,14,6,1,0,0,0,0,1,0,0,34,1,0,1,0,1,0,77,15,12,7,1,0,1,1,31,5,26,6,3,3,0,1
"1100 block lancaster av, Syracuse, NY",78,3,39,4,35,3,1,0,0,0,0,0,2,59,6,1,5,0,5,2,223,22,14,11,22,5,2,2,43,14,29,35,6,29,0,3
"1100 block madison st, Syracuse, NY",0,0,0,0,0,0,0,0,0,0,0,0,0,0,0,0,0,0,0,0,0,0,0,0,0,0,0,0,0,0,0,0,0,0,0,0
"1100 block salina st s, Syracuse, NY",0,0,0,0,0,0,0,0,0,0,0,0,0,0,0,0,0,0,0,0,0,0,0,0,0,0,0,0,0,0,0,0,0,0,0,0
"1100 block salt springs rd, Syracuse, NY",35,0,26,5,4,0,0,0,0,0,0,0,0,18,16,1,0,0,0,0,83,7,14,8,6,0,0,0,31,7,24,4,4,0,0,0
"1100 block spring st, Syracuse, NY",60,6,4,5,51,6,2,1,0,0,0,0,3,30,19,0,8,0,0,3,155,22,12,10,7,5,3,1,9,2,7,51,21,30,0,6
"1100 block sunnycrest rd, Syracuse, NY",36,1,31,4,1,1,0,0,0,0,1,0,0,36,0,0,0,0,0,0,103,7,11,7,3,7,1,0,35,9,26,1,1,0,0,1
"1100 block teal av, Syracuse, NY",0,0,0,0,0,0,0,0,0,0,0,0,0,0,0,0,0,0,0,0,0,0,0,0,0,0,0,0,0,0,0,0,0,0,0,0
"1100 block teall av, Syracuse, NY",79,7,25,8,46,7,3,0,1,1,1,0,1,68,8,1,0,0,0,2,187,29,20,15,5,7,3,0,33,10,23,46,16,30,0,7
"1100 block townsend st n, Syracuse, NY",208,38,4,11,193,38,31,0,0,0,0,0,7,149,35,1,21,0,0,2,430,125,34,13,15,5,10,6,15,1,14,193,37,156,0,38
"1100 block washington st e, Syracuse, NY",0,0,0,0,0,0,0,0,0,0,0,0,0,0,0,0,0,0,0,0,0,0,0,0,0,0,0,0,0,0,0,0,0,0,0,0
"1100 block westcott st, Syracuse, NY",0,0,0,0,0,0,0,0,0,0,0,0,0,0,0,0,0,0,0,0,0,0,0,0,0,0,0,0,0,0,0,0,0,0,0,0
"1100 block willis av, Syracuse, NY",3,0,0,0,3,0,0,0,0,0,0,0,0,3,0,0,0,0,0,0,5,2,0,1,0,0,0,0,0,0,0,3,1,2,0,0
"1100 block wolf st, Syracuse, NY",35,9,1,4,30,9,0,0,0,0,0,0,9,26,6,0,0,0,1,2,81,14,8,7,1,4,1,0,5,3,2,30,11,19,1,8
"1200 block almond st, Syracuse, NY",0,0,0,0,0,0,0,0,0,0,0,0,0,0,0,0,0,0,0,0,0,0,0,0,0,0,0,0,0,0,0,0,0,0,0,0
"1200 block bellevue av, Syracuse, NY",67,8,27,7,33,8,2,1,0,0,0,0,5,41,11,2,0,0,10,3,200,14,15,16,10,8,1,3,34,11,23,33,21,12,1,7
"1200 block burnet av, Syracuse, NY",11,1,1,4,6,1,0,0,0,0,0,0,1,10,0,1,0,0,0,0,20,5,5,0,0,1,0,0,5,1,4,6,1,5,0,1
"1200 block butternut st, Syracuse, NY",43,12,19,10,14,12,4,1,3,0,0,0,4,33,9,0,0,0,0,1,79,26,6,7,0,4,0,0,29,3,26,14,3,11,0,12
"1200 block fayette st e, Syracuse, NY",0,0,0,0,0,0,0,0,0,0,0,0,0,0,0,0,0,0,0,0,0,0,0,0,0,0,0,0,0,0,0,0,0,0,0,0
"1200 block first north st, Syracuse, NY",4,0,1,2,1,0,0,0,0,0,0,0,0,3,0,0,1,0,0,0,6,2,2,0,0,0,0,0,3,0,3,1,0,1,0,0
"1200 block genesee st e, Syracuse, NY",163,51,33,20,110,51,18,1,1,0,0,0,31,76,61,3,2,0,15,6,502,37,33,39,24,14,6,10,53,22,31,110,70,40,0,51
"1200 block genesee st w, Syracuse, NY",159,51,32,18,109,51,18,1,1,0,0,0,31,73,61,3,1,0,15,6,496,35,31,39,24,14,6,10,50,22,28,109,70,39,0,51
"1200 block grant blvd, Syracuse, NY",14,0,6,4,4,0,0,0,0,0,0,0,0,14,0,0,0,0,0,0,32,5,4,1,4,0,0,0,10,2,8,4,2,2,0,0
"1200 block highland st, Syracuse, NY",66,9,10,7,49,9,8,0,0,0,0,0,1,27,32,1,1,0,1,4,153,22,22,12,6,2,0,2,17,5,12,49,21,28,0,9
"1200 block ivy ridge rd, Syracuse, NY",24,0,2,2,20,0,0,0,0,0,0,0,0,13,9,0,0,0,0,2,49,12,6,2,2,1,1,0,4,1,3,20,4,16,0,0
"1200 block james st, Syracuse, NY",45,3,36,9,0,3,0,0,1,1,1,0,0,45,0,0,0,0,0,0,136,3,18,7,12,2,3,0,45,21,24,0,0,0,0,3
"1200 block midland av, Syracuse, NY",152,26,26,12,114,26,9,1,0,0,1,0,15,11,135,0,2,0,0,4,442,35,41,30,25,11,3,7,38,13,25,114,63,51,0,26
"1200 block milton av, Syracuse, NY",10,1,5,3,2,1,0,0,0,0,0,0,1,10,0,0,0,0,0,0,32,4,0,1,2,1,2,0,8,1,7,2,2,0,0,1
"1200 block onondaga st w, Syracuse, NY",22,0,5,2,15,0,0,0,0,0,0,0,0,13,7,0,0,0,0,2,67,5,5,4,3,2,3,0,7,1,6,15,13,2,0,0
"1200 block onondage st w, Syracuse, NY",80,7,19,9,52,7,1,0,1,0,3,0,2,40,29,1,1,0,7,2,231,21,18,16,12,4,6,3,28,8,20,52,30,22,3,4
"1200 block park st, Syracuse, NY",33,7,10,2,21,7,3,0,0,0,0,0,4,24,4,0,5,0,0,0,70,17,6,3,4,2,1,0,12,5,7,21,1,20,0,7
"1200 block salina st n, Syracuse, NY",0,0,0,0,0,0,0,0,0,0,0,0,0,0,0,0,0,0,0,0,0,0,0,0,0,0,0,0,0,0,0,0,0,0,0,0
"1200 block salina st s, Syracuse, NY",0,0,0,0,0,0,0,0,0,0,0,0,0,0,0,0,0,0,0,0,0,0,0,0,0,0,0,0,0,0,0,0,0,0,0,0
"1200 block salt springs rd, Syracuse, NY",34,4,19,8,7,4,1,0,1,0,0,0,2,14,18,0,0,0,0,2,88,10,8,7,5,3,1,0,27,8,19,7,3,4,0,4
"1200 block spring st, Syracuse, NY",23,1,1,9,13,1,0,0,0,0,0,0,1,20,0,0,1,0,1,1,60,7,10,1,1,1,1,2,10,0,10,13,5,8,0,1
"1200 block state st s, Syracuse, NY",53,2,13,3,37,2,0,0,0,0,0,0,2,10,43,0,0,0,0,0,154,9,15,13,9,5,0,2,16,6,10,37,29,8,0,2
"1200 block teall av, Syracuse, NY",52,2,30,10,12,2,0,0,0,0,1,0,1,42,3,2,2,0,1,2,110,17,24,3,5,2,1,0,40,8,32,12,4,8,0,2
"1200 block westcott st, Syracuse, NY",72,3,41,17,14,3,1,0,0,1,1,0,0,67,3,0,1,1,0,0,159,23,23,16,8,2,0,0,58,14,44,14,0,14,0,3
"1200 block willis av, Syracuse, NY",0,0,0,0,0,0,0,0,0,0,0,0,0,0,0,0,0,0,0,0,0,0,0,0,0,0,0,0,0,0,0,0,0,0,0,0
"1300 block adams st e, Syracuse, NY",41,0,0,0,41,0,0,0,0,0,0,0,0,33,2,0,6,0,0,0,150,3,7,12,9,3,3,4,0,0,0,41,0,41,0,0
"1300 block bellevue av, Syracuse, NY",92,8,38,17,37,8,2,0,1,0,0,0,5,53,30,1,1,0,4,3,247,21,35,15,10,5,1,5,55,13,42,37,20,17,0,8
"1300 block burnet av, Syracuse, NY",26,16,3,4,19,16,3,0,0,0,0,0,13,20,2,1,2,0,1,0,81,5,9,2,3,5,0,2,7,0,7,19,12,7,0,16
"1300 block erie blvd w, Syracuse, NY",58,10,12,11,35,10,0,0,0,0,0,0,10,45,7,1,0,0,3,2,140,20,19,6,5,5,2,1,23,5,18,35,16,19,0,10
"1300 block euclid av, Syracuse, NY",0,0,0,0,0,0,0,0,0,0,0,0,0,0,0,0,0,0,0,0,0,0,0,0,0,0,0,0,0,0,0,0,0,0,0,0
"1300 block fayette sch w, Syracuse, NY",0,0,0,0,0,0,0,0,0,0,0,0,0,0,0,0,0,0,0,0,0,0,0,0,0,0,0,0,0,0,0,0,0,0,0,0
"1300 block fayette st e, Syracuse, NY",45,47,3,1,41,47,1,0,44,1,0,0,1,5,36,0,0,0,2,2,149,9,8,12,4,6,2,4,4,1,3,41,27,14,0,47
"1300 block fayette st w, Syracuse, NY",51,14,6,3,42,14,10,0,2,0,0,0,2,39,11,1,0,0,0,0,130,16,12,10,7,4,2,0,9,5,4,42,19,23,1,13
"1300 block genesee st e, Syracuse, NY",0,0,0,0,0,0,0,0,0,0,0,0,0,0,0,0,0,0,0,0,0,0,0,0,0,0,0,0,0,0,0,0,0,0,0,0
"1300 block grant blvd, Syracuse, NY",31,2,19,5,7,2,1,0,0,0,0,0,1,31,0,0,0,0,0,0,59,11,14,4,2,0,0,0,24,2,22,7,2,5,0,2
"1300 block lancaster av, Syracuse, NY",73,3,53,13,7,3,0,0,1,0,0,0,2,65,3,0,3,0,0,2,148,28,28,11,4,0,1,1,66,15,51,7,2,5,0,3
"1300 block lodi st, Syracuse, NY",79,30,6,8,65,30,6,0,1,1,0,0,22,41,23,0,14,0,0,1,165,28,32,10,7,1,0,1,14,1,13,65,15,50,0,30
"1300 block madison st, Syracuse, NY",72,11,9,6,57,11,4,0,0,1,0,0,6,36,25,2,4,1,0,4,185,21,21,12,8,8,1,1,15,5,10,57,19,38,0,11
"1300 block midland av, Syracuse, NY",27,3,13,2,12,3,1,0,0,0,0,0,2,2,24,0,0,0,1,0,88,4,4,13,2,2,0,2,15,7,8,12,8,4,0,3
"1300 block oak st, Syracuse, NY",40,1,23,7,10,1,0,0,1,0,0,0,0,35,3,0,0,1,0,1,112,6,12,10,8,4,0,0,30,9,21,10,5,5,0,1
"1300 block salina st n, Syracuse, NY",3,3,0,0,3,3,1,0,0,0,0,0,2,1,0,0,2,0,0,0,5,1,2,0,0,0,0,0,0,0,0,3,0,3,0,3
"1300 block salt springs rd, Syracuse, NY",21,0,15,5,1,0,0,0,0,0,0,0,0,13,7,0,0,0,0,1,44,6,9,4,2,0,0,0,20,3,17,1,1,0,0,0
"1300 block spring st, Syracuse, NY",142,13,8,8,126,13,5,0,1,0,1,0,6,90,35,5,5,0,3,4,277,74,31,19,11,4,1,2,16,6,10,126,34,92,0,13
"1300 block water st e, Syracuse, NY",0,0,0,0,0,0,0,0,0,0,0,0,0,0,0,0,0,0,0,0,0,0,0,0,0,0,0,0,0,0,0,0,0,0,0,0
"1300 block willis av, Syracuse, NY",0,0,0,0,0,0,0,0,0,0,0,0,0,0,0,0,0,0,0,0,0,0,0,0,0,0,0,0,0,0,0,0,0,0,0,0
"1400 block colvin st w, Syracuse, NY",9,0,7,2,0,0,0,0,0,0,0,0,0,5,4,0,0,0,0,0,27,2,2,1,2,2,0,0,9,2,7,0,0,0,0,0
"1400 block comstock av, Syracuse, NY",174,2,15,3,156,2,2,0,0,0,0,0,0,115,30,0,18,0,3,8,299,88,61,15,6,4,0,0,18,4,14,156,16,140,0,2
"1400 block euclid av, Syracuse, NY",91,6,41,11,39,6,0,0,1,0,1,0,4,61,19,0,3,0,0,8,216,21,36,21,9,2,1,1,52,9,43,39,9,30,0,6
"1400 block fayette st e, Syracuse, NY",45,0,23,5,17,0,0,0,0,0,0,0,0,29,16,0,0,0,0,0,102,12,18,8,6,0,1,0,28,9,19,17,5,12,0,0
"1400 block genesee st e, Syracuse, NY",0,0,0,0,0,0,0,0,0,0,0,0,0,0,0,0,0,0,0,0,0,0,0,0,0,0,0,0,0,0,0,0,0,0,0,0
"1400 block genesee st w, Syracuse, NY",35,4,17,7,11,4,0,0,3,0,0,0,1,21,12,1,0,0,0,1,79,17,6,5,5,0,1,1,24,3,21,11,5,6,1,3
"1400 block genseee st w, Syracuse, NY",35,4,17,7,11,4,0,0,3,0,0,0,1,21,12,1,0,0,0,1,79,17,6,5,5,0,1,1,24,3,21,11,5,6,1,3
"1400 block grant blvd, Syracuse, NY",87,6,41,26,20,6,0,0,3,0,0,0,3,85,1,0,1,0,0,0,206,23,36,12,10,2,3,1,67,17,50,20,5,15,0,6
"1400 block hawley av, Syracuse, NY",0,0,0,0,0,0,0,0,0,0,0,0,0,0,0,0,0,0,0,0,0,0,0,0,0,0,0,0,0,0,0,0,0,0,0,0
"1400 block lemoyne av, Syracuse, NY",60,3,38,18,4,3,0,0,0,0,0,0,3,55,3,0,1,0,1,0,135,15,29,6,7,2,1,0,56,13,43,4,2,2,0,3
"1400 block mcbride st s, Syracuse, NY",48,0,0,0,48,0,0,0,0,0,0,0,0,2,42,0,1,0,0,3,101,22,11,9,3,1,1,1,0,0,0,48,24,24,0,0
"1400 block midland av, Syracuse, NY",0,0,0,0,0,0,0,0,0,0,0,0,0,0,0,0,0,0,0,0,0,0,0,0,0,0,0,0,0,0,0,0,0,0,0,0
"1400 block oak st, Syracuse, NY",19,3,7,3,9,3,0,0,1,0,0,0,2,12,1,1,2,0,3,0,57,9,1,2,2,3,0,2,10,5,5,9,5,4,0,3
"1400 block salina st n, Syracuse, NY",0,0,0,0,0,0,0,0,0,0,0,0,0,0,0,0,0,0,0,0,0,0,0,0,0,0,0,0,0,0,0,0,0,0,0,0
"1400 block salina st s, Syracuse, NY",1,0,0,0,1,0,0,0,0,0,0,0,0,1,0,0,0,0,0,0,1,1,0,0,0,0,0,0,0,0,0,1,0,1,0,0
"1400 block salt springs rd, Syracuse, NY",6,0,3,3,0,0,0,0,0,0,0,0,0,1,5,0,0,0,0,0,16,1,2,2,0,1,0,0,6,3,3,0,0,0,0,0
"1400 block state st n, Syracuse, NY",36,46,2,1,33,46,1,0,0,0,0,0,45,1,34,0,0,0,0,1,79,16,8,7,0,4,1,0,3,1,2,33,14,19,1,45
"1400 block state st s, Syracuse, NY",16,10,3,2,11,10,4,0,0,0,0,0,6,2,12,0,0,0,1,1,55,4,2,4,1,1,2,2,5,2,3,11,7,4,0,10
"1400 block washington st e, Syracuse, NY",156,4,8,3,145,4,4,0,0,0,0,0,0,14,127,0,1,0,3,11,513,30,28,39,24,16,6,13,11,5,6,145,97,48,0,4
"1500 block bellevue av, Syracuse, NY",15,2,7,4,4,2,0,0,0,0,0,0,2,15,0,0,0,0,0,0,34,2,8,4,1,0,0,0,11,3,8,4,1,3,0,2
"1500 block fayette st e, Syracuse, NY",49,4,8,10,31,4,1,0,0,2,0,0,1,25,15,1,4,0,3,1,133,12,15,9,4,6,3,0,18,2,16,31,12,19,0,4
"1500 block geddes st s, Syracuse, NY",11,3,6,2,3,3,0,0,1,0,0,0,2,2,9,0,0,0,0,0,28,3,3,2,2,1,0,0,8,4,4,3,0,3,0,3
"1500 block glenwood av, Syracuse, NY",22,1,17,5,0,1,0,0,0,0,0,0,1,22,0,0,0,0,0,0,41,8,10,3,1,0,0,0,22,1,21,0,0,0,0,1
"1500 block ivy ridge rd, Syracuse, NY",666,11,15,9,642,11,10,0,0,0,0,0,1,506,119,12,14,0,0,15,806,571,67,16,8,3,1,0,24,8,16,642,24,618,2,9
"1500 block lodi st, Syracuse, NY",21,3,0,0,21,3,3,0,0,0,0,0,0,11,3,1,6,0,0,0,31,15,4,0,2,0,0,0,0,0,0,21,3,18,0,3
"1500 block meadowbrook dr, Syracuse, NY",14,0,8,5,1,0,0,0,0,0,0,0,0,9,5,0,0,0,0,0,37,3,5,3,1,1,1,0,13,4,9,1,0,1,0,0
"1500 block onondaga st w, Syracuse, NY",44,18,10,4,30,18,2,0,12,0,0,0,4,24,12,4,0,0,0,4,146,14,4,6,6,6,6,2,14,6,8,30,16,14,0,18
"1500 block park st, Syracuse, NY",56,4,8,2,46,4,1,0,0,0,0,0,3,45,2,0,2,0,3,4,167,15,14,10,3,7,4,3,10,2,8,46,20,26,0,4
"1500 block salt springs rd, Syracuse, NY",0,0,0,0,0,0,0,0,0,0,0,0,0,0,0,0,0,0,0,0,0,0,0,0,0,0,0,0,0,0,0,0,0,0,0,0
"1500 block south av, Syracuse, NY",62,13,17,4,41,13,5,0,0,0,0,0,8,16,45,0,0,0,0,1,168,16,18,10,10,4,2,2,21,6,15,41,22,19,0,13
"1500 block state st n, Syracuse, NY",50,0,5,0,45,0,0,0,0,0,0,0,0,43,5,0,2,0,0,0,87,21,21,8,0,0,0,0,5,0,5,45,0,45,0,0
"1500 block state st s, Syracuse, NY",41,3,1,0,40,3,1,0,0,0,1,0,1,30,7,0,3,0,0,1,104,15,7,9,6,2,1,1,1,1,0,40,2,38,0,3
"1600 block bellevue av, Syracuse, NY",0,0,0,0,0,0,0,0,0,0,0,0,0,0,0,0,0,0,0,0,0,0,0,0,0,0,0,0,0,0,0,0,0,0,0,0
"1600 block erie blvd e, Syracuse, NY",314,54,34,34,246,54,25,0,1,0,0,0,28,150,142,5,5,0,5,7,715,145,67,44,21,16,13,8,68,15,53,246,83,163,1,53
"1600 block fayette st w, Syracuse, NY",8,3,0,0,8,3,3,0,0,0,0,0,0,0,7,1,0,0,0,0,15,3,3,2,0,0,0,0,0,0,0,8,3,5,0,3
"1600 block geddes st s, Syracuse, NY",0,0,0,0,0,0,0,0,0,0,0,0,0,0,0,0,0,0,0,0,0,0,0,0,0,0,0,0,0,0,0,0,0,0,0,0
"1600 block genesee st e, Syracuse, NY",101,7,9,1,91,7,4,0,0,2,0,0,1,45,29,0,21,0,3,3,254,35,28,9,17,7,3,2,10,5,5,91,15,76,1,6
"1600 block genesee st w, Syracuse, NY",0,0,0,0,0,0,0,0,0,0,0,0,0,0,0,0,0,0,0,0,0,0,0,0,0,0,0,0,0,0,0,0,0,0,0,0
"1600 block grant blvd, Syracuse, NY",126,8,39,49,38,8,2,0,3,1,0,0,2,114,8,1,0,0,0,3,263,48,51,7,10,8,2,0,88,13,75,38,11,27,0,8
"1600 block james st, Syracuse, NY",73,7,28,18,27,7,2,0,1,0,1,0,3,63,5,1,1,0,2,1,159,22,28,15,5,2,1,0,46,14,32,27,7,20,0,7
"1600 block lodi st, Syracuse, NY",27,6,1,2,24,6,0,0,0,0,0,0,6,7,13,1,5,0,0,1,83,8,5,5,4,2,1,2,3,0,3,24,13,11,0,6
"1600 block meadowbrook dr, Syracuse, NY",82,4,51,27,4,4,0,0,0,0,2,0,2,70,10,0,1,0,0,1,197,22,29,14,11,5,1,0,78,18,60,4,3,1,1,3
"1600 block onondaga st w, Syracuse, NY",189,16,66,33,90,16,8,1,2,0,0,0,5,123,46,1,0,0,8,11,453,55,66,33,21,8,3,3,99,24,75,90,35,55,0,16
"1600 block park st, Syracuse, NY",24,4,2,1,21,4,2,0,0,0,0,0,2,23,0,0,0,0,0,1,72,5,5,4,6,3,1,0,3,2,1,21,11,10,0,4
"1600 block salina st n, Syracuse, NY",82,12,40,4,38,12,8,0,2,0,0,0,2,58,21,1,1,0,1,0,245,20,18,12,17,9,3,3,44,17,27,38,23,15,2,10
"1600 block saltsprings rd, Syracuse, NY",21,2,13,7,1,2,0,0,2,0,0,0,0,16,2,0,2,0,0,1,41,7,11,1,1,1,0,0,20,4,16,1,0,1,0,2
"1600 block south av, Syracuse, NY",49,3,18,7,24,3,2,0,1,0,0,0,0,19,29,0,0,0,0,1,145,11,11,13,6,3,1,4,25,8,17,24,17,7,1,2
"1700 block bellevue av, Syracuse, NY",0,0,0,0,0,0,0,0,0,0,0,0,0,0,0,0,0,0,0,0,0,0,0,0,0,0,0,0,0,0,0,0,0,0,0,0
"1700 block butternut st, Syracuse, NY",20,1,9,5,6,1,1,0,0,0,0,0,0,19,0,0,0,0,0,1,43,7,6,5,1,1,0,0,14,3,11,6,2,4,0,1
"1700 block grant blvd, Syracuse, NY",20,0,6,8,6,0,0,0,0,0,0,0,0,13,4,0,3,0,0,0,67,3,5,3,5,3,0,1,14,4,10,6,5,1,0,0
"1700 block lodi st, Syracuse, NY",78,11,12,13,53,11,6,0,1,0,0,0,4,50,12,1,12,0,0,3,232,23,13,6,24,6,4,2,25,9,16,53,34,19,0,11
"1700 block meadowbrook dr, Syracuse, NY",178,15,72,28,78,15,7,0,1,0,0,0,7,128,31,1,12,0,1,5,505,48,44,21,38,14,9,4,100,33,67,78,44,34,0,15
"1700 block onondaga st w, Syracuse, NY",100,4,60,15,25,4,1,0,0,0,0,0,3,78,19,0,0,0,1,2,273,25,31,15,14,8,5,2,75,24,51,25,10,15,0,4
"1700 block park st, Syracuse, NY",0,0,0,0,0,0,0,0,0,0,0,0,0,0,0,0,0,0,0,0,0,0,0,0,0,0,0,0,0,0,0,0,0,0,0,0
"1700 block salina st n, Syracuse, NY",24,0,13,6,5,0,0,0,0,0,0,0,0,20,2,0,0,0,1,1,41,12,8,3,1,0,0,0,19,2,17,5,2,3,0,0
"1700 block salina st s, Syracuse, NY",34,3,14,2,18,3,0,0,1,0,0,0,2,22,8,1,1,0,1,1,111,10,4,6,5,2,5,2,16,5,11,18,10,8,1,2
"1700 block state st s, Syracuse, NY",30,8,10,8,12,8,2,1,3,0,0,0,2,17,9,0,0,0,4,0,99,4,10,6,2,3,3,2,18,8,10,12,8,4,0,8
"1700 block valley dr, Syracuse, NY",48,4,17,7,24,4,2,0,2,0,0,0,0,37,11,0,0,0,0,0,94,20,18,4,4,2,0,0,24,5,19,24,3,21,0,4
"1800 block bellevue av, Syracuse, NY",44,4,28,10,6,4,0,0,0,2,0,0,2,37,6,1,0,0,0,0,124,7,16,7,7,6,1,0,38,6,32,6,6,0,0,4
"1800 block euclid av, Syracuse, NY",22,0,12,8,2,0,0,0,0,0,0,0,0,20,0,0,0,0,0,2,55,6,8,2,4,1,1,0,20,5,15,2,1,1,0,0
"1800 block genesee st w, Syracuse, NY",55,8,7,2,46,8,2,0,0,1,0,0,5,36,6,0,8,0,3,2,140,19,16,8,5,2,1,4,9,4,5,46,4,42,0,8
"1800 block james st, Syracuse, NY",38,3,18,14,6,3,1,0,0,0,0,0,2,37,0,0,0,0,0,1,86,8,17,9,3,1,0,0,32,6,26,6,3,3,0,3
"1800 block midland av, Syracuse, NY",42,12,9,11,22,12,2,0,0,0,0,0,10,8,31,0,0,0,2,1,147,6,6,11,10,3,3,3,20,7,13,22,18,4,0,12
"1800 block salina st s, Syracuse, NY",17,6,7,1,9,6,1,0,0,0,0,0,5,0,17,0,0,0,0,0,56,1,6,5,2,1,0,2,8,2,6,9,8,1,0,6
"1800 block south av, Syracuse, NY",22,1,16,5,1,1,0,0,0,0,0,0,1,17,3,0,1,0,0,1,56,7,8,3,1,2,0,1,21,5,16,1,0,1,0,1
"1800 block state st s, Syracuse, NY",16,1,2,0,14,1,0,0,0,0,0,0,1,0,16,0,0,0,0,0,43,5,4,1,3,3,0,0,2,0,2,14,8,6,0,1
"1900 block bellevue av, Syracuse, NY",33,1,16,14,3,1,0,0,1,0,0,0,0,32,0,0,0,0,1,0,72,11,12,5,3,2,0,0,30,9,21,3,0,3,0,1
"1900 block caleb av, Syracuse, NY",0,0,0,0,0,0,0,0,0,0,0,0,0,0,0,0,0,0,0,0,0,0,0,0,0,0,0,0,0,0,0,0,0,0,0,0
"1900 block erie blvd e, Syracuse, NY",0,1,0,0,0,1,0,0,0,0,0,0,1,0,0,0,0,0,0,0,0,0,0,0,0,0,0,0,0,0,0,0,0,0,0,1
"1900 block euclid av, Syracuse, NY",43,0,25,17,1,0,0,0,0,0,0,0,0,41,1,0,1,0,0,0,75,21,15,4,3,0,0,0,42,6,36,1,0,1,0,0
"1900 block fayette st e, Syracuse, NY",26,14,3,5,18,14,0,0,0,2,0,0,12,5,18,0,0,0,0,3,92,8,6,4,2,1,1,4,8,3,5,18,7,11,0,14
"1900 block fayette st w, Syracuse, NY",0,0,0,0,0,0,0,0,0,0,0,0,0,0,0,0,0,0,0,0,0,0,0,0,0,0,0,0,0,0,0,0,0,0,0,0
"1900 block genesee st e, Syracuse, NY",95,10,14,11,70,10,1,0,0,0,0,0,9,56,29,1,5,0,3,1,224,30,30,19,9,5,0,2,25,3,22,70,14,56,0,10
"1900 block grant blvd, Syracuse, NY",113,12,46,21,46,12,3,0,0,1,1,0,7,85,16,2,4,0,1,5,298,32,27,22,19,9,3,1,67,25,42,46,23,23,0,12
"1900 block salina st s, Syracuse, NY",81,21,23,13,45,21,16,0,2,0,1,0,2,7,67,1,0,0,1,5,255,18,20,15,9,7,7,5,36,12,24,45,19,26,0,21
"1900 block south av, Syracuse, NY",163,20,92,26,45,20,2,0,4,0,1,0,13,93,65,2,0,0,3,0,407,38,67,23,18,10,5,2,118,36,82,45,24,21,0,20
"1900 block valley dr, Syracuse, NY",36,2,8,3,25,2,1,0,0,0,1,0,0,22,13,1,0,0,0,0,73,12,14,7,3,0,0,0,11,1,10,25,9,16,0,2
"200 block academy pl, Syracuse, NY",62,3,42,17,3,3,0,0,0,0,1,0,2,61,1,0,0,0,0,0,147,17,21,12,10,0,2,0,59,17,42,3,1,2,0,3
"200 block adams st e, Syracuse, NY",0,0,0,0,0,0,0,0,0,0,0,0,0,0,0,0,0,0,0,0,0,0,0,0,0,0,0,0,0,0,0,0,0,0,0,0
"200 block apple st, Syracuse, NY",44,5,2,1,41,5,5,0,0,0,0,0,0,35,7,1,0,0,1,0,63,31,9,3,0,1,0,0,3,0,3,41,3,38,0,5
"200 block ash st, Syracuse, NY",20,13,1,3,16,13,2,0,8,0,0,0,3,8,6,2,3,0,1,0,42,9,6,0,4,1,0,0,4,1,3,16,3,13,0,13
"200 block ashworth pl, Syracuse, NY",0,0,0,0,0,0,0,0,0,0,0,0,0,0,0,0,0,0,0,0,0,0,0,0,0,0,0,0,0,0,0,0,0,0,0,0
"200 block avery av, Syracuse, NY",21,0,9,3,9,0,0,0,0,0,0,0,0,20,0,0,1,0,0,0,44,10,5,3,0,3,0,0,12,4,8,9,1,8,0,0
"200 block baker av, Syracuse, NY",0,0,0,0,0,0,0,0,0,0,0,0,0,0,0,0,0,0,0,0,0,0,0,0,0,0,0,0,0,0,0,0,0,0,0,0
"200 block ballantyne rd, Syracuse, NY",18,2,6,1,11,2,0,0,0,0,0,0,2,7,11,0,0,0,0,0,50,5,5,3,2,2,0,1,7,3,4,11,3,8,1,1
"200 block barrington rd, Syracuse, NY",42,2,25,17,0,2,0,0,1,0,0,0,1,40,1,0,0,0,0,1,95,13,18,4,3,2,2,0,42,9,33,0,0,0,0,2
"200 block basin st, Syracuse, NY",86,6,2,0,84,6,5,0,0,0,1,0,0,67,3,1,14,0,0,1,115,63,20,2,0,0,1,0,2,0,2,84,3,81,0,6
"200 block beard av w, Syracuse, NY",114,7,2,0,112,7,6,0,0,0,1,0,0,71,26,1,14,0,0,2,189,68,30,9,2,4,1,0,2,0,2,112,19,93,0,7
"200 block beech st s, Syracuse, NY",28,1,0,0,28,1,1,0,0,0,0,0,0,4,23,0,0,0,0,1,74,5,10,7,2,4,0,0,0,0,0,28,16,12,0,1
"200 block beecher st, Syracuse, NY",40,1,6,4,30,1,0,0,0,0,1,0,0,21,10,1,3,0,5,0,111,13,9,5,5,6,1,1,10,4,6,30,15,15,0,1
"200 block belden ave, Syracuse, NY",0,0,0,0,0,0,0,0,0,0,0,0,0,0,0,0,0,0,0,0,0,0,0,0,0,0,0,0,0,0,0,0,0,0,0,0
"200 block bellevue av, Syracuse, NY",29,7,4,2,23,7,6,0,0,0,0,0,1,2,25,0,0,0,2,0,67,8,10,7,2,2,0,0,6,2,4,23,10,13,1,6
"200 block berkeley dr, Syracuse, NY",38,0,20,12,6,0,0,0,0,0,0,0,0,36,2,0,0,0,0,0,101,6,15,11,2,1,2,1,32,7,25,6,2,4,0,0
"200 block borden av w, Syracuse, NY",12,10,0,3,9,10,1,0,0,0,0,0,9,1,11,0,0,0,0,0,34,4,2,1,3,1,1,0,3,1,2,9,4,5,0,10
"200 block brampton rd, Syracuse, NY",0,0,0,0,0,0,0,0,0,0,0,0,0,0,0,0,0,0,0,0,0,0,0,0,0,0,0,0,0,0,0,0,0,0,0,0
"200 block brattle rd, Syracuse, NY",49,4,27,15,7,4,1,0,1,0,0,0,2,47,1,0,1,0,0,0,110,14,17,12,5,0,1,0,42,7,35,7,5,2,0,4
"200 block brighton av w, Syracuse, NY",61,8,18,2,41,8,2,0,0,0,0,0,6,8,52,0,0,0,1,0,221,12,12,8,12,6,4,7,20,10,10,41,24,17,0,8
"200 block brookford rd, Syracuse, NY",131,13,54,26,51,13,3,0,1,1,0,0,8,72,56,1,1,0,1,0,373,35,36,22,19,7,5,7,80,19,61,51,31,20,0,13
"200 block brooklea pl, Syracuse, NY",21,1,9,9,3,1,0,0,0,1,0,0,0,17,3,1,0,0,0,0,42,9,7,2,2,1,0,0,18,2,16,3,2,1,0,1
"200 block bruce st, Syracuse, NY",22,0,12,6,4,0,0,0,0,0,0,0,0,7,12,0,2,0,0,1,58,6,6,5,2,2,0,1,18,5,13,4,4,0,0,0
"200 block buckingham av, Syracuse, NY",66,2,2,2,62,2,1,0,1,0,0,0,0,63,0,0,1,0,2,0,187,13,16,19,9,5,4,0,4,0,4,62,1,61,0,2
"200 block burnet av, Syracuse, NY",0,0,0,0,0,0,0,0,0,0,0,0,0,0,0,0,0,0,0,0,0,0,0,0,0,0,0,0,0,0,0,0,0,0,0,0
"200 block cadwell st, Syracuse, NY",63,12,11,5,47,12,4,0,0,0,0,0,8,39,18,2,0,0,2,2,175,15,21,9,6,6,5,1,16,4,12,47,23,24,1,11
"200 block caleb av, Syracuse, NY",38,0,10,8,20,0,0,0,0,0,0,0,0,35,0,0,0,0,3,0,70,17,12,7,2,0,0,0,18,2,16,20,5,15,0,0
"200 block calthrop av w, Syracuse, NY",66,5,24,12,30,5,1,0,0,0,0,0,4,13,46,1,1,0,2,3,183,11,17,22,12,0,4,0,36,13,23,30,19,11,2,3
"200 block cambridge st, Syracuse, NY",28,2,4,2,22,2,2,0,0,0,0,0,0,20,5,0,1,0,0,2,74,4,11,7,4,1,1,0,6,0,6,22,1,21,0,2
"200 block cannon st, Syracuse, NY",25,25,2,0,23,25,4,0,0,0,0,0,21,0,23,0,0,0,0,2,73,6,6,7,2,2,1,1,2,1,1,23,14,9,2,23
"200 block carbon st, Syracuse, NY",15,12,7,1,7,12,10,0,0,0,2,0,0,5,4,1,5,0,0,0,43,3,5,3,1,1,2,0,8,4,4,7,2,5,0,12
"200 block catherine st, Syracuse, NY",0,0,0,0,0,0,0,0,0,0,0,0,0,0,0,0,0,0,0,0,0,0,0,0,0,0,0,0,0,0,0,0,0,0,0,0
"200 block chavez ter, Syracuse, NY",0,0,0,0,0,0,0,0,0,0,0,0,0,0,0,0,0,0,0,0,0,0,0,0,0,0,0,0,0,0,0,0,0,0,0,0
"200 block cheltenham rd e, Syracuse, NY",15,0,7,2,6,0,0,0,0,0,0,0,0,13,0,2,0,0,0,0,34,8,2,4,0,0,0,1,9,3,6,6,0,6,0,0
"200 block chemung st, Syracuse, NY",79,10,13,8,58,10,3,0,0,0,0,0,7,71,6,2,0,0,0,0,184,33,24,6,3,7,4,2,21,3,18,58,21,37,1,9
"200 block cherry st, Syracuse, NY",6,0,0,0,6,0,0,0,0,0,0,0,0,0,4,0,0,0,1,1,23,0,0,4,0,1,1,0,0,0,0,6,6,0,0,0
"200 block clarendon st, Syracuse, NY",18,2,7,5,6,2,2,0,0,0,0,0,0,14,2,0,2,0,0,0,47,4,5,5,2,2,0,0,12,3,9,6,0,6,0,2
"200 block clinton st n, Syracuse, NY",0,0,0,0,0,0,0,0,0,0,0,0,0,0,0,0,0,0,0,0,0,0,0,0,0,0,0,0,0,0,0,0,0,0,0,0
"200 block coleridge av, Syracuse, NY",79,8,10,10,59,8,5,0,0,0,0,0,3,69,7,0,0,0,1,2,155,35,26,6,10,2,0,0,20,4,16,59,11,48,0,8
"200 block collingwood av s, Syracuse, NY",61,2,20,7,34,2,0,0,1,0,0,0,1,53,4,0,1,0,0,3,132,21,21,10,6,3,0,0,27,9,18,34,10,24,0,2
"200 block colvin st w, Syracuse, NY",22,6,10,2,10,6,2,1,0,0,0,0,3,3,14,1,0,0,2,2,64,5,7,5,1,2,0,2,12,4,8,10,6,4,0,6
"200 block comstock av, Syracuse, NY",1,1,0,0,1,1,0,0,0,0,0,0,1,1,0,0,0,0,0,0,2,0,1,0,0,0,0,0,0,0,0,1,0,1,0,1
"200 block corning av w, Syracuse, NY",13,3,1,3,9,3,0,1,0,0,0,0,2,1,11,0,0,0,0,1,43,1,2,5,2,3,0,0,4,0,4,9,8,1,0,3
"200 block craddock st, Syracuse, NY",31,2,19,3,9,2,0,0,1,0,0,0,1,22,7,1,0,0,1,0,92,6,8,5,7,4,0,1,22,6,16,9,6,3,0,2
"200 block crafton av, Syracuse, NY",87,4,57,23,7,4,0,0,0,2,1,0,1,69,14,1,0,0,0,3,202,24,32,19,7,2,2,1,80,17,63,7,3,4,0,4
"200 block croly st, Syracuse, NY",0,0,0,0,0,0,0,0,0,0,0,0,0,0,0,0,0,0,0,0,0,0,0,0,0,0,0,0,0,0,0,0,0,0,0,0
"200 block dale st, Syracuse, NY",36,5,18,7,11,5,3,0,1,1,0,0,0,31,3,2,0,0,0,0,88,14,9,3,4,5,1,0,25,8,17,11,5,6,1,4
"200 block delhi st, Syracuse, NY",44,15,13,5,26,15,6,0,3,0,0,0,6,29,9,1,1,0,0,4,125,8,17,8,5,2,0,4,18,5,13,26,15,11,0,15
"200 block delray av, Syracuse, NY",97,9,28,12,57,9,4,1,0,0,1,0,3,87,2,3,1,0,2,2,203,35,41,12,3,2,0,4,40,5,35,57,7,50,0,9
"200 block demong dr, Syracuse, NY",0,0,0,0,0,0,0,0,0,0,0,0,0,0,0,0,0,0,0,0,0,0,0,0,0,0,0,0,0,0,0,0,0,0,0,0
"200 block dewitt rd, Syracuse, NY",0,0,0,0,0,0,0,0,0,0,0,0,0,0,0,0,0,0,0,0,0,0,0,0,0,0,0,0,0,0,0,0,0,0,0,0
"200 block dorchester av, Syracuse, NY",8,0,2,6,0,0,0,0,0,0,0,0,0,8,0,0,0,0,0,0,18,3,2,1,2,0,0,0,8,2,6,0,0,0,0,0
"200 block douglas st, Syracuse, NY",79,14,2,0,77,14,8,0,0,1,0,0,5,52,25,1,1,0,0,0,133,50,16,6,4,2,0,1,2,0,2,77,12,65,1,13
"200 block duane st, Syracuse, NY",35,2,14,5,16,2,0,0,0,0,0,0,2,22,4,2,2,0,4,1,109,6,10,8,3,3,3,2,19,8,11,16,12,4,0,2,0,0,0,0,,,,,,,,,,,,
"200 block east av, Syracuse, NY",162,8,80,50,32,8,3,0,1,1,0,0,3,113,46,0,0,0,1,2,396,39,72,20,16,11,1,3,130,23,107,32,21,11,0,8
"200 block edwards av s, Syracuse, NY",132,16,68,26,38,16,2,2,0,0,0,0,12,118,10,0,0,0,2,2,286,52,38,24,6,10,2,0,94,24,70,38,12,26,0,16
"200 block eldorado st, Syracuse, NY",22,3,8,1,13,3,1,0,0,0,0,0,2,20,2,0,0,0,0,0,44,10,6,3,2,1,0,0,9,4,5,13,3,10,0,3
"200 block elsner st, Syracuse, NY",53,5,30,5,18,5,1,0,1,1,0,0,2,39,10,0,0,0,0,4,129,22,9,13,2,4,1,2,35,10,25,18,6,12,0,5
"200 block empire av, Syracuse, NY",29,5,13,5,11,5,0,0,2,2,0,0,1,13,14,1,0,0,0,1,68,13,4,3,8,0,1,0,18,6,12,11,5,6,0,5
"200 block erickson st, Syracuse, NY",28,2,20,3,5,2,0,0,1,0,0,0,1,25,3,0,0,0,0,0,54,14,9,2,0,2,1,0,23,4,19,5,1,4,0,2
"200 block erie st, Syracuse, NY",153,9,28,22,103,9,5,0,0,2,0,0,2,139,7,0,0,0,3,4,366,47,53,23,17,7,2,4,50,15,35,103,39,64,1,8
"200 block euclid av, Syracuse, NY",33,0,0,0,33,0,0,0,0,0,0,0,0,19,3,0,6,0,4,1,94,4,27,0,1,0,0,1,0,0,0,33,0,33,0,0
"200 block fayette blvd, Syracuse, NY",18,2,14,4,0,2,0,0,1,0,0,0,1,13,5,0,0,0,0,0,49,4,6,3,3,1,0,1,18,7,11,0,0,0,0,2
"200 block fayette st w, Syracuse, NY",62,8,2,7,53,8,1,0,0,0,0,0,7,53,7,0,1,0,1,0,118,33,14,8,4,2,0,1,9,2,7,53,8,45,0,8
"200 block fellows av, Syracuse, NY",24,0,12,12,0,0,0,0,0,0,0,0,0,22,0,0,2,0,0,0,46,11,8,3,1,0,1,0,24,4,20,0,0,0,0,0
"200 block fenway dr, Syracuse, NY",88,3,18,8,62,3,0,0,2,1,0,0,0,21,59,1,0,0,5,2,193,26,34,17,7,4,0,0,26,6,20,62,25,37,0,3
"200 block fillmore av, Syracuse, NY",19,0,8,5,6,0,0,0,0,0,0,0,0,19,0,0,0,0,0,0,51,7,4,1,3,3,1,0,13,4,9,6,2,4,0,0
"200 block fitch st, Syracuse, NY",22,15,1,6,15,15,10,0,0,0,0,0,5,11,4,0,0,0,3,4,65,7,4,4,3,0,3,1,7,3,4,15,5,10,0,15
"200 block forest hill dr, Syracuse, NY",37,0,18,7,12,0,0,0,0,0,0,0,0,34,1,1,0,0,0,1,85,11,14,6,3,2,1,0,25,3,22,12,2,10,0,0
"200 block franklin st n, Syracuse, NY",0,0,0,0,0,0,0,0,0,0,0,0,0,0,0,0,0,0,0,0,0,0,0,0,0,0,0,0,0,0,0,0,0,0,0,0
"200 block franklin st s, Syracuse, NY",3,0,0,0,3,0,0,0,0,0,0,0,0,2,0,0,0,0,1,0,3,3,0,0,0,0,0,0,0,0,0,3,0,3,0,0
"200 block furman st, Syracuse, NY",0,0,0,0,0,0,0,0,0,0,0,0,0,0,0,0,0,0,0,0,0,0,0,0,0,0,0,0,0,0,0,0,0,0,0,0
"200 block geddes sq s, Syracuse, NY",2,1,0,1,1,1,1,0,0,0,0,0,0,1,0,0,0,0,0,1,3,1,1,0,0,0,0,0,1,0,1,1,0,1,0,1
"200 block geddes st n, Syracuse, NY",27,5,3,7,17,5,1,1,0,0,0,0,3,26,1,0,0,0,0,0,70,7,8,7,2,2,0,1,10,0,10,17,9,8,0,5
"200 block genesee park dr, Syracuse, NY",49,2,34,12,3,2,0,0,0,1,0,0,1,18,29,0,1,0,0,1,131,11,18,7,6,5,1,1,46,19,27,3,2,1,0,2
"200 block genesee pkwy e, Syracuse, NY",0,0,0,0,0,0,0,0,0,0,0,0,0,0,0,0,0,0,0,0,0,0,0,0,0,0,0,0,0,0,0,0,0,0,0,0
"200 block genesee st w, Syracuse, NY",0,0,0,0,0,0,0,0,0,0,0,0,0,0,0,0,0,0,0,0,0,0,0,0,0,0,0,0,0,0,0,0,0,0,0,0
"200 block gertrude st, Syracuse, NY",0,0,0,0,0,0,0,0,0,0,0,0,0,0,0,0,0,0,0,0,0,0,0,0,0,0,0,0,0,0,0,0,0,0,0,0
"200 block gifford pkwy, Syracuse, NY",14,3,10,4,0,3,0,0,1,0,0,0,2,13,1,0,0,0,0,0,42,0,8,1,2,3,0,0,14,4,10,0,0,0,0,3
"200 block gilbert av, Syracuse, NY",18,4,11,2,5,4,0,0,1,0,0,0,3,14,3,0,1,0,0,0,40,6,6,4,1,0,1,0,13,3,10,5,1,4,0,4
"200 block glenwood av, Syracuse, NY",16,2,10,3,3,2,1,0,0,1,0,0,0,10,5,0,0,0,0,1,44,2,6,3,4,1,0,0,13,3,10,3,3,0,0,2
"200 block goodrich av, Syracuse, NY",39,9,18,9,12,9,4,1,0,0,0,0,4,31,3,0,2,1,2,0,84,12,17,7,2,0,0,1,27,7,20,12,2,10,1,8
"200 block grand av, Syracuse, NY",64,15,8,7,49,15,3,1,0,1,0,0,10,29,22,1,0,1,8,3,218,10,12,15,13,3,9,2,15,4,11,49,33,16,0,15
"200 block griffiths st, Syracuse, NY",42,2,17,9,16,2,1,0,1,0,0,0,0,32,6,0,2,0,2,0,125,8,10,9,9,4,0,2,26,11,15,16,8,8,0,2
"200 block grumbach av, Syracuse, NY",34,5,12,1,21,5,4,0,0,0,0,0,1,22,7,0,3,0,0,2,101,8,10,6,5,2,1,2,13,5,8,21,10,11,3,2
"200 block harriette av, Syracuse, NY",12,1,5,3,4,1,0,0,0,0,0,0,1,7,5,0,0,0,0,0,25,6,2,2,1,1,0,0,8,1,7,4,2,2,0,1
"200 block harrison st, Syracuse, NY",0,0,0,0,0,0,0,0,0,0,0,0,0,0,0,0,0,0,0,0,0,0,0,0,0,0,0,0,0,0,0,0,0,0,0,0
"200 block hawley av, Syracuse, NY",26,8,5,1,20,8,8,0,0,0,0,0,0,16,4,1,2,0,0,3,66,6,10,3,5,1,1,0,6,0,6,20,10,10,0,8
"200 block hayden av, Syracuse, NY",36,7,2,4,30,7,6,0,0,0,0,0,1,29,5,0,1,0,0,1,89,10,10,9,3,4,0,0,6,2,4,30,14,16,2,5
"200 block helen st, Syracuse, NY",1,0,1,0,0,0,0,0,0,0,0,0,0,1,0,0,0,0,0,0,2,0,1,0,0,0,0,0,1,0,1,0,0,0,0,0
"200 block herald pl, Syracuse, NY",0,0,0,0,0,0,0,0,0,0,0,0,0,0,0,0,0,0,0,0,0,0,0,0,0,0,0,0,0,0,0,0,0,0,0,0
"200 block herbert st, Syracuse, NY",23,2,13,6,4,2,1,0,0,0,0,0,1,18,0,0,4,0,0,1,56,9,5,5,1,1,1,1,19,5,14,4,2,2,0,2
"200 block herkimer st, Syracuse, NY",110,15,27,12,71,15,9,0,2,3,0,0,1,86,11,3,0,0,1,9,285,40,22,19,15,6,4,4,39,10,29,71,36,35,5,10
"200 block hiawatha blvd e, Syracuse, NY",44,6,11,2,31,6,1,1,0,0,0,0,4,30,8,1,1,0,1,3,122,11,12,5,11,3,1,1,13,7,6,31,17,14,0,6
"200 block hiawatha blvd w, Syracuse, NY",0,0,0,0,0,0,0,0,0,0,0,0,0,0,0,0,0,0,0,0,0,0,0,0,0,0,0,0,0,0,0,0,0,0,0,0
"200 block hier av, Syracuse, NY",18,2,5,3,10,2,1,0,0,0,0,0,1,7,5,0,5,0,1,0,72,2,4,1,2,4,4,1,8,5,3,10,5,5,0,2
"200 block hillsboro pkwy, Syracuse, NY",40,2,29,5,6,2,0,0,0,0,1,0,1,20,20,0,0,0,0,0,95,13,12,8,3,2,2,0,34,10,24,6,0,6,1,1
"200 block hillside av, Syracuse, NY",62,0,33,22,7,0,0,0,0,0,0,0,0,52,7,0,0,0,2,1,127,26,23,2,8,1,2,0,55,9,46,7,2,5,0,0
"200 block hoefler st, Syracuse, NY",55,2,32,10,13,2,0,0,1,0,0,0,1,51,2,2,0,0,0,0,130,11,25,12,4,2,0,1,42,9,33,13,5,8,0,2
"200 block holland st, Syracuse, NY",36,0,3,2,31,0,0,0,0,0,0,0,0,6,20,0,0,0,9,1,133,0,10,11,3,7,4,1,5,4,1,31,24,7,0,0
"200 block homecroft rd, Syracuse, NY",63,1,11,4,48,1,0,1,0,0,0,0,0,50,11,0,0,0,2,0,82,51,6,5,1,0,0,0,15,5,10,48,0,48,0,1
"200 block hubbell av, Syracuse, NY",59,1,29,9,21,1,1,0,0,0,0,0,0,56,3,0,0,0,0,0,142,14,24,8,9,4,0,0,38,12,26,21,10,11,0,1
"200 block hudson st, Syracuse, NY",25,4,3,4,18,4,0,0,0,0,0,0,4,0,23,0,0,0,1,1,65,7,6,4,7,0,1,0,7,1,6,18,11,7,1,3
"200 block hunt av, Syracuse, NY",35,8,8,5,22,8,1,0,0,0,0,0,7,8,26,1,0,0,0,0,99,4,15,7,5,3,0,1,13,3,10,22,14,8,0,8
"200 block hurlburt rd, Syracuse, NY",0,0,0,0,0,0,0,0,0,0,0,0,0,0,0,0,0,0,0,0,0,0,0,0,0,0,0,0,0,0,0,0,0,0,0,0
"200 block james st, Syracuse, NY",0,0,0,0,0,0,0,0,0,0,0,0,0,0,0,0,0,0,0,0,0,0,0,0,0,0,0,0,0,0,0,0,0,0,0,0
"200 block jamesville av, Syracuse, NY",33,4,8,5,20,4,1,0,2,0,0,0,1,20,10,0,2,0,1,0,88,5,12,9,4,2,1,0,13,1,12,20,8,12,0,4
"200 block jefferson st e, Syracuse, NY",12,4,1,0,11,4,4,0,0,0,0,0,0,11,0,0,1,0,0,0,20,7,3,1,1,0,0,0,1,0,1,11,2,9,1,3
"200 block jefferson st w, Syracuse, NY",0,0,0,0,0,0,0,0,0,0,0,0,0,0,0,0,0,0,0,0,0,0,0,0,0,0,0,0,0,0,0,0,0,0,0,0
"200 block kellogg st, Syracuse, NY",30,5,6,5,19,5,0,0,0,0,0,0,5,13,6,1,0,0,9,1,86,6,10,6,3,3,0,2,11,2,9,19,12,7,0,5
"200 block kenmore av, Syracuse, NY",28,0,15,5,8,0,0,0,0,0,0,0,0,18,8,0,1,0,1,0,66,10,8,5,2,1,2,0,20,6,14,8,2,6,0,0
"200 block kennedy st e, Syracuse, NY",38,0,0,0,38,0,0,0,0,0,0,0,0,29,8,1,0,0,0,0,49,27,11,0,0,0,0,0,0,0,0,38,0,38,0,0
"200 block kennedy ter w, Syracuse, NY",26,0,4,4,18,0,0,0,0,0,0,0,0,21,0,1,0,0,1,3,65,5,11,6,2,1,0,1,8,1,7,18,10,8,0,0
"200 block kimber av, Syracuse, NY",11,7,4,1,6,7,0,0,0,0,0,0,7,3,7,1,0,0,0,0,32,4,0,2,3,2,0,0,5,1,4,6,4,2,1,6
"200 block kirk av, Syracuse, NY",91,28,19,7,65,28,13,0,0,0,1,0,14,9,78,0,0,0,2,2,309,12,23,19,18,13,1,5,26,8,18,65,42,23,4,24
"200 block kirkpatrick st, Syracuse, NY",0,0,0,0,0,0,0,0,0,0,0,0,0,0,0,0,0,0,0,0,0,0,0,0,0,0,0,0,0,0,0,0,0,0,0,0
"200 block knaul st, Syracuse, NY",27,5,3,1,23,5,2,0,0,0,0,0,3,20,2,0,4,0,0,1,82,8,2,5,8,1,3,0,4,1,3,23,11,12,0,5
"200 block lafayette av w, Syracuse, NY",0,0,0,0,0,0,0,0,0,0,0,0,0,0,0,0,0,0,0,0,0,0,0,0,0,0,0,0,0,0,0,0,0,0,0,0
"200 block lafayette rd, Syracuse, NY",40,1,24,12,4,1,0,0,0,0,0,0,1,30,5,2,1,0,0,2,97,15,8,8,6,2,0,1,36,12,24,4,1,3,0,1
"200 block lakeview av, Syracuse, NY",0,0,0,0,0,0,0,0,0,0,0,0,0,0,0,0,0,0,0,0,0,0,0,0,0,0,0,0,0,0,0,0,0,0,0,0
"200 block lemoyne av, Syracuse, NY",37,8,4,3,30,8,4,0,0,0,0,0,4,24,9,3,0,0,0,1,78,12,16,5,2,1,1,0,7,1,6,30,9,21,0,8
"200 block lexington av, Syracuse, NY",15,7,3,0,12,7,5,0,0,0,0,0,2,4,9,0,2,0,0,0,56,4,4,2,1,1,0,3,3,1,2,12,4,8,0,7
"200 block lilac st, Syracuse, NY",176,66,10,8,158,66,34,0,0,2,0,0,30,80,48,6,32,0,6,4,480,72,26,34,16,8,6,14,18,2,16,158,64,94,0,66
"200 block lime st, Syracuse, NY",24,3,12,9,3,3,0,0,1,0,0,0,2,23,1,0,0,0,0,0,57,6,9,6,1,1,1,0,21,3,18,3,0,3,0,3
"200 block lincoln av, Syracuse, NY",59,23,8,11,40,23,8,2,0,1,0,0,12,9,43,0,0,0,3,4,158,19,18,5,8,3,3,3,19,4,15,40,22,18,0,23
"200 block loomis av, Syracuse, NY",67,3,19,5,43,3,3,0,0,0,0,0,0,28,34,0,0,0,2,3,153,20,24,13,7,1,1,1,24,8,16,43,17,26,1,2
"200 block lorraine av, Syracuse, NY",15,0,8,5,2,0,0,0,0,0,0,0,0,13,1,0,1,0,0,0,28,7,6,0,1,1,0,0,13,3,10,2,0,2,0,0
"200 block maplehurst av, Syracuse, NY",24,1,11,5,8,1,0,0,1,0,0,0,0,23,0,0,0,0,0,1,54,9,7,4,3,0,0,1,16,2,14,8,1,7,0,1
"200 block marcellus st w, Syracuse, NY",27,2,10,4,13,2,2,0,0,0,0,0,0,22,1,1,3,0,0,0,36,18,9,0,0,0,0,0,14,0,14,13,0,13,1,1
"200 block marguerite av, Syracuse, NY",22,4,6,3,13,4,4,0,0,0,0,0,0,9,10,1,0,0,2,0,61,3,7,6,4,2,0,0,9,4,5,13,9,4,1,3
"200 block mariposa st, Syracuse, NY",35,2,17,8,10,2,0,0,0,0,0,0,2,30,2,0,0,0,0,3,76,8,16,9,1,1,0,0,25,6,19,10,5,5,0,2
"200 block marshall st, Syracuse, NY",6,0,0,0,6,0,0,0,0,0,0,0,0,6,0,0,0,0,0,0,13,0,5,1,0,0,0,0,0,0,0,6,0,6,0,0
"200 block martin luther king   w, Syracuse, NY",20,1,5,6,9,1,1,0,0,0,0,0,0,3,17,0,0,0,0,0,55,4,8,3,1,3,0,1,11,2,9,9,5,4,0,1
"200 block mary st, Syracuse, NY",47,6,12,3,32,6,0,0,4,0,0,0,2,29,9,0,5,0,1,3,162,10,7,5,11,9,2,3,15,6,9,32,22,10,0,6
"200 block mather st, Syracuse, NY",45,3,13,11,21,3,2,0,0,0,0,0,1,40,2,0,1,0,0,2,95,15,18,7,4,0,0,1,24,6,18,21,7,14,0,3
"200 block may av, Syracuse, NY",23,3,9,3,11,3,0,0,0,0,0,0,3,15,5,1,0,0,1,1,61,5,6,7,3,1,1,0,12,4,8,11,8,3,0,3
"200 block melbourne av, Syracuse, NY",29,1,9,5,15,1,1,0,0,0,0,0,0,16,11,1,1,0,0,0,44,16,12,0,1,0,0,0,14,1,13,15,0,15,0,1
"200 block midler av s, Syracuse, NY",28,1,1,0,27,1,1,0,0,0,0,0,0,25,1,0,1,0,0,1,30,26,2,0,0,0,0,0,1,0,1,27,0,27,0,1
"200 block miles av, Syracuse, NY",84,4,45,21,18,4,0,0,1,0,1,0,2,76,6,0,2,0,0,0,179,28,32,12,11,0,0,1,66,12,54,18,6,12,0,4
"200 block milford dr, Syracuse, NY",12,0,8,2,2,0,0,0,0,0,0,0,0,12,0,0,0,0,0,0,22,6,3,2,1,0,0,0,10,2,8,2,0,2,0,0
"200 block milton av, Syracuse, NY",97,6,45,14,38,6,1,0,0,2,0,0,3,87,2,1,1,0,4,2,212,34,38,10,9,3,1,2,59,9,50,38,6,32,1,5
"200 block mlk   e, Syracuse, NY",40,21,3,6,31,21,13,0,0,0,0,0,8,6,33,0,0,0,0,1,127,6,11,9,6,4,1,3,9,4,5,31,24,7,1,20
"200 block montgomery st, Syracuse, NY",0,0,0,0,0,0,0,0,0,0,0,0,0,0,0,0,0,0,0,0,0,0,0,0,0,0,0,0,0,0,0,0,0,0,0,0
"200 block monticello dr  n, Syracuse, NY",22,35,6,3,13,35,1,0,2,0,0,0,32,9,11,1,0,0,0,1,57,6,7,3,3,2,1,0,9,5,4,13,5,8,0,35
"200 block moore av, Syracuse, NY",0,0,0,0,0,0,0,0,0,0,0,0,0,0,0,0,0,0,0,0,0,0,0,0,0,0,0,0,0,0,0,0,0,0,0,0
"200 block mosley dr, Syracuse, NY",44,12,14,6,24,12,9,0,2,1,0,0,0,34,7,0,0,0,1,2,105,9,19,8,6,2,0,0,20,4,16,24,10,14,0,12
"200 block mountainview av, Syracuse, NY",200,25,21,7,172,25,22,0,1,0,0,0,2,77,102,1,3,0,6,11,444,70,64,37,20,3,5,1,28,4,24,172,63,109,0,25
"200 block myrtle st, Syracuse, NY",51,4,30,11,10,4,1,0,1,1,0,0,1,49,1,0,1,0,0,0,112,20,15,6,7,2,1,0,41,12,29,10,0,10,0,4
"200 block newell st w, Syracuse, NY",142,21,0,0,142,21,21,0,0,0,0,0,0,81,52,1,4,0,1,3,150,135,6,1,0,0,0,0,0,0,0,142,0,142,1,20
"200 block oakwood av, Syracuse, NY",0,0,0,0,0,0,0,0,0,0,0,0,0,0,0,0,0,0,0,0,0,0,0,0,0,0,0,0,0,0,0,0,0,0,0,0
"200 block oneida st, Syracuse, NY",8,48,0,0,8,48,0,0,32,0,0,0,16,7,0,0,0,0,1,0,12,6,1,0,1,0,0,0,0,0,0,8,2,6,1,47
"200 block onondaga av, Syracuse, NY",0,0,0,0,0,0,0,0,0,0,0,0,0,0,0,0,0,0,0,0,0,0,0,0,0,0,0,0,0,0,0,0,0,0,0,0
"200 block onondaga st e, Syracuse, NY",0,0,0,0,0,0,0,0,0,0,0,0,0,0,0,0,0,0,0,0,0,0,0,0,0,0,0,0,0,0,0,0,0,0,0,0
"200 block ostrander av w, Syracuse, NY",0,0,0,0,0,0,0,0,0,0,0,0,0,0,0,0,0,0,0,0,0,0,0,0,0,0,0,0,0,0,0,0,0,0,0,0
"200 block parkway dr, Syracuse, NY",37,8,22,8,7,8,2,0,1,0,0,0,5,27,10,0,0,0,0,0,114,9,6,8,5,7,1,1,30,14,16,7,3,4,2,6
"200 block paul av, Syracuse, NY",117,14,51,16,50,14,6,0,1,0,0,0,7,104,7,0,0,0,1,5,259,39,41,19,12,4,1,1,67,19,48,50,14,36,0,14
"200 block plymouth dr, Syracuse, NY",128,6,73,34,21,6,2,0,1,0,0,0,3,119,5,2,1,0,0,1,314,37,48,16,13,8,3,3,107,24,83,21,6,15,0,6
"200 block primrose av, Syracuse, NY",2,1,1,0,1,1,0,0,0,0,1,0,0,0,2,0,0,0,0,0,8,0,1,0,0,0,1,0,1,0,1,1,1,0,0,1
"200 block pulaski st, Syracuse, NY",0,0,0,0,0,0,0,0,0,0,0,0,0,0,0,0,0,0,0,0,0,0,0,0,0,0,0,0,0,0,0,0,0,0,0,0
"200 block reed av, Syracuse, NY",22,1,2,5,15,1,0,0,0,0,1,0,0,16,5,1,0,0,0,0,42,8,10,3,0,1,0,0,7,2,5,15,5,10,0,1
"200 block ridgewood dr, Syracuse, NY",18,1,2,2,14,1,1,0,0,0,0,0,0,16,2,0,0,0,0,0,23,13,5,0,0,0,0,0,4,0,4,14,1,13,0,1
"200 block robert dr, Syracuse, NY",13,3,4,1,8,3,1,0,0,0,0,0,2,4,7,0,2,0,0,0,32,3,4,4,1,1,0,0,5,1,4,8,1,7,0,3
"200 block roberts dr, Syracuse, NY",60,3,36,11,13,3,1,0,0,0,0,0,2,49,7,0,4,0,0,0,153,10,27,11,7,2,3,0,47,14,33,13,2,11,0,3
"200 block rockland av, Syracuse, NY",0,0,0,0,0,0,0,0,0,0,0,0,0,0,0,0,0,0,0,0,0,0,0,0,0,0,0,0,0,0,0,0,0,0,0,0
"200 block roxbury rd, Syracuse, NY",99,11,34,11,54,11,10,0,1,0,0,0,0,83,11,0,0,0,0,5,161,58,28,7,4,2,0,0,45,8,37,54,4,50,1,10
"200 block rugby rd, Syracuse, NY",39,3,14,4,21,3,3,0,0,0,0,0,0,32,7,0,0,0,0,0,77,17,12,6,2,2,0,0,18,3,15,21,9,12,0,3
"200 block salina st s, Syracuse, NY",0,0,0,0,0,0,0,0,0,0,0,0,0,0,0,0,0,0,0,0,0,0,0,0,0,0,0,0,0,0,0,0,0,0,0,0
"200 block scotholm blvd, Syracuse, NY",51,1,36,13,2,1,0,0,0,0,1,0,0,48,3,0,0,0,0,0,121,16,16,7,9,2,1,0,49,15,34,2,1,1,0,1
"200 block scottholm ter, Syracuse, NY",1,0,1,0,0,0,0,0,0,0,0,0,0,1,0,0,0,0,0,0,1,1,0,0,0,0,0,0,1,0,1,0,0,0,0,0
"200 block searlwyn rd, Syracuse, NY",36,0,24,11,1,0,0,0,0,0,0,0,0,33,3,0,0,0,0,0,83,14,9,6,4,2,0,1,35,10,25,1,0,1,0,0
"200 block second north st, Syracuse, NY",44,5,22,6,16,5,0,0,1,0,0,0,4,40,3,0,0,0,0,1,117,11,15,10,1,4,2,1,28,5,23,16,10,6,1,4
"200 block sedgwick st, Syracuse, NY",176,7,9,1,166,7,5,0,1,0,0,0,1,139,24,2,3,0,6,2,282,106,50,10,6,2,2,0,10,4,6,166,17,149,2,5
"200 block seneca dr, Syracuse, NY",126,6,21,18,87,6,4,0,0,0,0,0,2,37,79,2,0,0,2,6,274,40,46,27,7,3,3,0,39,11,28,87,39,48,0,6
"200 block seneca tpke w, Syracuse, NY",0,0,0,0,0,0,0,0,0,0,0,0,0,0,0,0,0,0,0,0,0,0,0,0,0,0,0,0,0,0,0,0,0,0,0,0
"200 block seventh north st, Syracuse, NY",17,1,8,6,3,1,0,0,0,0,0,0,1,17,0,0,0,0,0,0,33,7,7,0,3,0,0,0,14,1,13,3,1,2,0,1
"200 block seward st, Syracuse, NY",0,0,0,0,0,0,0,0,0,0,0,0,0,0,0,0,0,0,0,0,0,0,0,0,0,0,0,0,0,0,0,0,0,0,0,0
"200 block solar st, Syracuse, NY",0,0,0,0,0,0,0,0,0,0,0,0,0,0,0,0,0,0,0,0,0,0,0,0,0,0,0,0,0,0,0,0,0,0,0,0
"200 block stafford av, Syracuse, NY",0,0,0,0,0,0,0,0,0,0,0,0,0,0,0,0,0,0,0,0,0,0,0,0,0,0,0,0,0,0,0,0,0,0,0,0
"200 block state st n, Syracuse, NY",1,0,0,1,0,0,0,0,0,0,0,0,0,0,0,0,0,0,0,1,1,1,0,0,0,0,0,0,1,0,1,0,0,0,0,0
"200 block state st s, Syracuse, NY",0,0,0,0,0,0,0,0,0,0,0,0,0,0,0,0,0,0,0,0,0,0,0,0,0,0,0,0,0,0,0,0,0,0,0,0
"200 block strathmore dr, Syracuse, NY",31,2,12,6,13,2,1,0,0,0,0,0,1,23,6,1,0,0,0,1,73,8,11,7,3,2,0,0,18,5,13,13,4,9,0,2
"200 block strong av, Syracuse, NY",0,0,0,0,0,0,0,0,0,0,0,0,0,0,0,0,0,0,0,0,0,0,0,0,0,0,0,0,0,0,0,0,0,0,0,0
"200 block sunrise dr, Syracuse, NY",222,4,137,71,14,4,0,0,3,0,0,0,1,191,26,1,0,0,0,4,488,73,81,33,26,5,3,1,208,41,167,14,8,6,1,3
"200 block sunstruck dr, Syracuse, NY",33,4,13,5,15,4,0,0,0,0,1,0,3,27,3,0,0,0,1,2,90,10,7,7,5,2,0,2,18,5,13,15,8,7,0,4
"200 block tennyson av, Syracuse, NY",30,1,8,5,17,1,0,0,0,0,0,0,1,29,0,1,0,0,0,0,50,18,7,2,3,0,0,0,13,1,12,17,3,14,0,1
"200 block tompkins st, Syracuse, NY",1,0,0,0,1,0,0,0,0,0,0,0,0,1,0,0,0,0,0,0,3,0,0,1,0,0,0,0,0,0,0,1,0,1,0,0
"200 block towers ln, Syracuse, NY",146,4,0,1,145,4,2,2,0,0,0,0,0,11,127,0,0,0,4,4,289,67,43,19,9,6,1,1,1,1,0,145,63,82,0,4
"200 block ulster st, Syracuse, NY",0,0,0,0,0,0,0,0,0,0,0,0,0,0,0,0,0,0,0,0,0,0,0,0,0,0,0,0,0,0,0,0,0,0,0,0
"200 block union pl, Syracuse, NY",0,0,0,0,0,0,0,0,0,0,0,0,0,0,0,0,0,0,0,0,0,0,0,0,0,0,0,0,0,0,0,0,0,0,0,0
"200 block van buren st, Syracuse, NY",0,0,0,0,0,0,0,0,0,0,0,0,0,0,0,0,0,0,0,0,0,0,0,0,0,0,0,0,0,0,0,0,0,0,0,0
"200 block vann st, Syracuse, NY",63,2,11,7,45,2,0,0,0,1,0,0,1,49,10,1,1,0,2,0,148,20,19,13,7,3,0,1,18,3,15,45,18,27,0,2
"200 block wainwright av, Syracuse, NY",81,2,46,17,18,2,0,0,0,0,0,0,2,74,4,1,0,0,0,2,189,25,26,18,6,3,2,1,63,16,47,18,5,13,0,2
"200 block wall st, Syracuse, NY",37,7,7,2,28,7,0,0,5,0,0,0,2,30,6,0,0,0,0,1,84,16,10,3,6,1,0,1,9,3,6,28,8,20,0,7
"200 block walton st, Syracuse, NY",18,0,1,0,17,0,0,0,0,0,0,0,0,9,7,0,0,0,2,0,26,14,3,0,0,0,1,0,1,0,1,17,1,16,0,0
"200 block washington sq, Syracuse, NY",48,1,27,10,11,1,1,0,0,0,0,0,0,42,4,0,1,0,0,1,104,20,14,6,5,1,1,1,37,8,29,11,4,7,0,1
"200 block washington st e, Syracuse, NY",53,3,0,0,53,3,2,0,0,0,0,0,1,37,3,0,12,0,0,1,63,45,6,2,0,0,0,0,0,0,0,53,2,51,0,3
"200 block water st e, Syracuse, NY",45,11,0,0,45,11,6,0,0,0,0,0,5,23,13,0,3,0,4,2,65,31,9,4,1,0,0,0,0,0,0,45,5,40,0,11
"200 block water st w, Syracuse, NY",24,1,0,0,24,1,1,0,0,0,0,0,0,21,3,0,0,0,0,0,34,18,3,2,1,0,0,0,0,0,0,24,3,21,0,1
"200 block westminster av, Syracuse, NY",0,0,0,0,0,0,0,0,0,0,0,0,0,0,0,0,0,0,0,0,0,0,0,0,0,0,0,0,0,0,0,0,0,0,0,0
"200 block westmoreland av, Syracuse, NY",191,8,0,1,190,8,5,1,0,0,1,0,1,13,151,1,0,1,10,15,377,83,59,28,15,4,2,0,1,1,0,190,74,116,0,8
"200 block westwood rd, Syracuse, NY",0,0,0,0,0,0,0,0,0,0,0,0,0,0,0,0,0,0,0,0,0,0,0,0,0,0,0,0,0,0,0,0,0,0,0,0
"200 block whitwell dr, Syracuse, NY",53,14,20,5,28,14,2,0,5,0,0,0,7,33,11,1,8,0,0,0,162,13,12,10,9,2,3,4,25,8,17,28,17,11,0,14
"200 block wilkinson st, Syracuse, NY",0,0,0,0,0,0,0,0,0,0,0,0,0,0,0,0,0,0,0,0,0,0,0,0,0,0,0,0,0,0,0,0,0,0,0,0
"200 block willow st w, Syracuse, NY",4,1,0,0,4,1,1,0,0,0,0,0,0,4,0,0,0,0,0,0,4,4,0,0,0,0,0,0,0,0,0,4,0,4,0,1
"200 block willumae dr, Syracuse, NY",46,2,21,13,12,2,0,0,0,0,1,0,1,43,2,0,1,0,0,0,95,19,15,6,4,1,0,1,34,5,29,12,2,10,0,2
"200 block wilson st, Syracuse, NY",49,5,16,9,24,5,1,0,1,1,0,0,2,42,2,0,2,0,2,1,110,19,14,7,3,6,0,0,25,5,20,24,9,15,0,5
"200 block wolf st, Syracuse, NY",0,0,0,0,0,0,0,0,0,0,0,0,0,0,0,0,0,0,0,0,0,0,0,0,0,0,0,0,0,0,0,0,0,0,0,0
"200 block woodbine av, Syracuse, NY",108,7,31,11,66,7,2,1,0,1,0,0,3,81,16,4,3,0,1,3,224,53,24,10,13,7,1,0,42,15,27,66,12,54,0,7
"200 block woodlawn ter, Syracuse, NY",45,3,20,9,16,3,2,0,0,0,0,0,1,37,4,1,2,0,1,0,103,16,14,7,4,3,0,1,29,3,26,16,6,10,0,3
"200 block woodruff av, Syracuse, NY",47,7,10,6,31,7,1,0,4,0,0,0,2,35,6,2,1,0,0,3,115,20,10,10,1,0,2,4,16,4,12,31,9,22,0,7
"200 block wyoming st, Syracuse, NY",#REF!,#REF!,#REF!,#REF!,#REF!,#REF!,#REF!,#REF!,#REF!,#REF!,#REF!,#REF!,#REF!,#REF!,#REF!,#REF!,#REF!,#REF!,#REF!,#REF!,#REF!,#REF!,#REF!,#REF!,#REF!,#REF!,#REF!,#REF!,#REF!,#REF!,#REF!,#REF!,#REF!,#REF!,#REF!,#REF!
"2000 block colvin st e, Syracuse, NY",0,0,0,0,0,0,0,0,0,0,0,0,0,0,0,0,0,0,0,0,0,0,0,0,0,0,0,0,0,0,0,0,0,0,0,0
"2000 block erie blvd e, Syracuse, NY",110,8,9,2,99,8,3,1,0,0,1,0,3,47,53,0,5,1,0,4,213,56,27,12,9,5,1,0,11,6,5,99,28,71,0,8
"2000 block genesee st e, Syracuse, NY",1,0,0,0,1,0,0,0,0,0,0,0,0,0,1,0,0,0,0,0,1,1,0,0,0,0,0,0,0,0,0,1,0,1,0,0
"2000 block grant blvd, Syracuse, NY",32,5,14,7,11,5,0,0,0,1,0,0,4,29,3,0,0,0,0,0,68,9,14,6,2,1,0,0,21,7,14,11,5,6,0,5
"2000 block james st, Syracuse, NY",1,0,0,0,1,0,0,0,0,0,0,0,0,1,0,0,0,0,0,0,2,0,1,0,0,0,0,0,0,0,0,1,0,1,0,0
"2000 block lodi st, Syracuse, NY",90,27,6,13,71,27,9,0,0,0,0,0,18,48,21,1,17,0,2,1,228,39,14,16,8,3,6,4,19,3,16,71,31,40,0,27
"2000 block south av, Syracuse, NY",64,4,30,11,23,4,2,0,1,0,0,0,1,29,31,0,0,0,3,1,163,22,16,13,7,2,1,3,41,13,28,23,12,11,0,4
"2100 block erie blvd e, Syracuse, NY",43,10,12,0,31,10,5,0,0,0,0,0,5,15,28,0,0,0,0,0,113,15,8,6,9,4,0,1,12,3,9,31,15,16,0,10
"2100 block fayette st e, Syracuse, NY",5,0,1,2,2,0,0,0,0,0,0,0,0,5,0,0,0,0,0,0,10,2,2,0,1,0,0,0,3,0,3,2,1,1,0,0
"2100 block geddes st s, Syracuse, NY",13,4,6,3,4,4,2,0,0,0,0,0,2,13,0,0,0,0,0,0,27,6,3,1,3,0,0,0,9,4,5,4,1,3,0,4
"2100 block genesee st e, Syracuse, NY",0,0,0,0,0,0,0,0,0,0,0,0,0,0,0,0,0,0,0,0,0,0,0,0,0,0,0,0,0,0,0,0,0,0,0,0
"2100 block grant blvd, Syracuse, NY",61,10,21,12,28,10,5,1,1,0,0,0,3,49,6,0,1,0,1,4,146,18,19,12,8,3,0,1,33,9,24,28,10,18,1,9
"2100 block park st, Syracuse, NY",0,0,0,0,0,0,0,0,0,0,0,0,0,0,0,0,0,0,0,0,0,0,0,0,0,0,0,0,0,0,0,0,0,0,0,0
"2100 block salina st s, Syracuse, NY",3,1,0,0,3,1,0,0,0,0,0,0,1,0,3,0,0,0,0,0,7,0,2,1,0,0,0,0,0,0,0,3,0,3,0,1
"2100 block state st s, Syracuse, NY",17,2,4,3,10,2,1,0,0,0,0,0,1,1,14,0,0,0,2,0,56,5,3,3,1,0,3,2,7,3,4,10,6,4,0,2
"2200 block fayette st e, Syracuse, NY",0,0,0,0,0,0,0,0,0,0,0,0,0,0,0,0,0,0,0,0,0,0,0,0,0,0,0,0,0,0,0,0,0,0,0,0
"2200 block lodi st, Syracuse, NY",46,5,1,2,43,5,5,0,0,0,0,0,0,32,7,3,2,0,0,2,108,18,10,5,10,3,0,0,3,2,1,43,14,29,0,5
"2200 block salina st s, Syracuse, NY",56,14,16,12,28,14,2,0,0,0,0,0,12,9,41,0,0,0,0,6,161,16,7,13,12,4,4,0,28,9,19,28,20,8,0,14
"2300 block erie blvd e, Syracuse, NY",0,0,0,0,0,0,0,0,0,0,0,0,0,0,0,0,0,0,0,0,0,0,0,0,0,0,0,0,0,0,0,0,0,0,0,0
"2300 block genesee st e, Syracuse, NY",42,15,11,9,22,15,2,0,0,0,0,0,13,11,30,0,0,0,0,1,146,5,15,3,8,5,1,5,20,6,14,22,17,5,3,12
"2300 block grant blvd, Syracuse, NY",56,0,26,9,21,0,0,0,0,0,0,0,0,47,7,0,0,0,0,2,135,14,22,10,7,1,1,1,35,7,28,21,8,13,0,0
"2300 block james st, Syracuse, NY",156,9,81,40,35,9,3,0,2,0,0,0,4,146,7,2,0,0,0,1,336,51,61,24,11,7,2,0,121,27,94,35,9,26,0,9
"2300 block lodi st, Syracuse, NY",39,9,2,7,30,9,3,0,2,0,0,0,4,25,8,0,4,0,0,2,88,12,17,2,5,2,1,0,9,1,8,30,12,18,0,9
"2300 block state st s, Syracuse, NY",37,11,9,5,23,11,2,0,2,0,0,0,7,5,30,0,0,0,0,2,102,12,10,4,2,6,2,1,14,3,11,23,11,12,0,11
"2400 block grant blvd, Syracuse, NY",0,0,0,0,0,0,0,0,0,0,0,0,0,0,0,0,0,0,0,0,0,0,0,0,0,0,0,0,0,0,0,0,0,0,0,0
"2400 block james st, Syracuse, NY",0,0,0,0,0,0,0,0,0,0,0,0,0,0,0,0,0,0,0,0,0,0,0,0,0,0,0,0,0,0,0,0,0,0,0,0
"2400 block midland av, Syracuse, NY",113,24,33,23,57,24,3,0,1,1,0,0,19,26,75,2,0,0,4,6,349,26,19,27,16,17,4,4,56,25,31,57,30,27,0,24
"2400 block salina st s, Syracuse, NY",42,4,11,9,22,4,0,0,0,0,0,0,4,5,35,0,1,0,1,0,139,9,10,8,5,3,3,4,20,8,12,22,9,13,0,4
"2400 block south av, Syracuse, NY",59,1,35,14,10,1,0,0,1,0,0,0,0,41,14,1,0,0,2,1,147,18,20,8,5,5,1,2,49,14,35,10,4,6,0,1
"2500 block bellevue av, Syracuse, NY",50,1,34,15,1,1,0,0,0,0,0,0,1,50,0,0,0,0,0,0,97,21,17,6,6,0,0,0,49,8,41,1,0,1,0,1
"2500 block lodi st, Syracuse, NY",0,0,0,0,0,0,0,0,0,0,0,0,0,0,0,0,0,0,0,0,0,0,0,0,0,0,0,0,0,0,0,0,0,0,0,0
"2600 block burnet av, Syracuse, NY",28,3,13,13,2,3,0,0,1,0,1,0,1,16,12,0,0,0,0,0,65,9,10,5,1,2,0,1,26,6,20,2,1,1,0,3
"2600 block erie blvd e, Syracuse, NY",96,15,7,3,86,15,14,0,0,0,0,0,1,43,41,0,2,0,3,7,129,75,12,6,3,0,0,0,10,2,8,86,5,81,0,15
"2600 block genesee st e, Syracuse, NY",86,1,44,6,36,1,0,0,1,0,0,0,0,35,41,0,2,0,0,8,235,17,26,18,18,4,1,2,50,16,34,36,18,18,0,1
"2600 block lodi st, Syracuse, NY",0,0,0,0,0,0,0,0,0,0,0,0,0,0,0,0,0,0,0,0,0,0,0,0,0,0,0,0,0,0,0,0,0,0,0,0
"2600 block midland av, Syracuse, NY",23,1,13,7,3,1,0,0,1,0,0,0,0,11,9,0,0,0,0,3,59,5,7,6,3,2,0,0,20,8,12,3,3,0,0,1
"2600 block salina st s, Syracuse, NY",55,12,7,8,40,12,8,0,0,0,0,0,4,7,42,1,0,0,0,5,128,17,18,11,3,6,0,0,15,3,12,40,18,22,1,11
"2700 block burnet av, Syracuse, NY",53,1,17,12,24,1,0,0,0,0,0,0,1,46,4,1,1,0,0,1,98,22,21,7,2,1,0,0,29,4,25,24,6,18,0,1
"2700 block erie blvd e, Syracuse, NY",73,6,46,18,9,6,1,0,2,0,1,0,2,33,39,0,0,0,0,1,167,25,27,9,4,6,0,2,64,10,54,9,3,6,0,6
"2700 block lodi st, Syracuse, NY",0,0,0,0,0,0,0,0,0,0,0,0,0,0,0,0,0,0,0,0,0,0,0,0,0,0,0,0,0,0,0,0,0,0,0,0
"2800 block burnet av, Syracuse, NY",19,2,4,6,9,2,0,0,0,0,0,0,2,17,1,1,0,0,0,0,37,11,0,6,2,0,0,0,10,1,9,9,3,6,1,1
"2800 block erie blvd e, Syracuse, NY",36,0,8,1,27,0,0,0,0,0,0,0,0,33,2,0,1,0,0,0,59,20,11,4,0,1,0,0,9,2,7,27,4,23,0,0
"2800 block genesee st e, Syracuse, NY",27,0,14,13,0,0,0,0,0,0,0,0,0,26,1,0,0,0,0,0,57,3,19,4,1,0,0,0,27,2,25,0,0,0,0,0
"2800 block james st, Syracuse, NY",208,12,60,29,119,12,5,0,1,0,0,0,6,172,24,5,0,0,3,4,447,86,65,22,16,16,2,1,89,25,64,119,25,94,0,12
"2800 block salina st s, Syracuse, NY",41,21,4,7,30,21,20,0,0,0,0,0,1,3,33,2,0,0,3,0,98,14,9,10,5,2,1,0,11,1,10,30,17,13,1,20
"2900 block burnet av, Syracuse, NY",42,5,6,4,32,5,3,0,0,0,0,0,2,31,8,1,0,0,0,2,66,27,9,3,3,0,0,0,10,0,10,32,6,26,0,5
"2900 block erie blvd e, Syracuse, NY",0,0,0,0,0,0,0,0,0,0,0,0,0,0,0,0,0,0,0,0,0,0,0,0,0,0,0,0,0,0,0,0,0,0,0,0
"2900 block erie blvd, Syracuse, NY",291,38,70,40,181,38,28,0,1,0,0,0,9,206,65,8,0,0,6,6,611,127,83,35,24,18,3,1,110,26,84,181,48,133,1,37
"2900 block genesee st e, Syracuse, NY",15,5,10,4,1,5,0,0,2,1,2,0,0,14,1,0,0,0,0,0,28,6,5,4,0,0,0,0,14,3,11,1,0,1,0,5
"2900 block james st, Syracuse, NY",83,7,26,12,45,7,3,0,3,0,1,0,0,69,11,1,1,0,0,1,153,35,32,11,4,1,0,0,38,5,33,45,11,34,1,6
"2900 block salina st s, Syracuse, NY",10,0,9,0,1,0,0,0,0,0,0,0,0,9,1,0,0,0,0,0,26,2,4,2,1,0,1,0,9,3,6,1,0,1,0,0
"300 block allen st, Syracuse, NY",19,3,6,0,13,3,2,0,0,0,0,0,1,2,17,0,0,0,0,0,65,2,1,10,2,3,0,1,6,3,3,13,10,3,0,3
"300 block arlington av, Syracuse, NY",25,5,13,3,9,5,1,0,0,0,0,0,4,14,8,0,0,0,3,0,81,4,5,7,4,2,1,2,16,6,10,9,6,3,0,5
"300 block arthur st, Syracuse, NY",61,2,19,10,32,2,0,0,0,0,0,0,2,28,21,1,0,0,7,4,185,14,15,14,11,2,0,5,29,8,21,32,22,10,0,2
"300 block ash st, Syracuse, NY",30,7,3,3,24,7,5,1,0,0,0,0,1,16,3,0,9,0,1,1,115,5,4,7,1,5,7,1,6,2,4,24,14,10,0,7
"300 block audobon pkwy, Syracuse, NY",37,1,20,13,4,1,0,0,1,0,0,0,0,20,17,0,0,0,0,0,112,12,9,2,6,2,3,3,33,12,21,4,2,2,0,1
"300 block audubon pkwy, Syracuse, NY",37,1,20,13,4,1,0,0,1,0,0,0,0,20,17,0,0,0,0,0,112,12,9,2,6,2,3,3,33,12,21,4,2,2,0,1
"300 block avery av, Syracuse, NY",2,0,0,0,2,0,0,0,0,0,0,0,0,2,0,0,0,0,0,0,2,2,0,0,0,0,0,0,0,0,0,2,0,2,0,0
"300 block baker av, Syracuse, NY",0,0,0,0,0,0,0,0,0,0,0,0,0,0,0,0,0,0,0,0,0,0,0,0,0,0,0,0,0,0,0,0,0,0,0,0
"300 block ballantyne rd, Syracuse, NY",0,0,0,0,0,0,0,0,0,0,0,0,0,0,0,0,0,0,0,0,0,0,0,0,0,0,0,0,0,0,0,0,0,0,0,0
"300 block barrington rd, Syracuse, NY",18,0,10,7,1,0,0,0,0,0,0,0,0,16,2,0,0,0,0,0,36,8,5,2,3,0,0,0,17,4,13,1,1,0,0,0
"300 block basin st, Syracuse, NY",32,4,3,4,25,4,3,0,0,0,0,0,1,20,7,0,2,0,3,0,67,16,6,6,2,1,0,1,7,2,5,25,7,18,0,4
"300 block bear st, Syracuse, NY",0,0,0,0,0,0,0,0,0,0,0,0,0,0,0,0,0,0,0,0,0,0,0,0,0,0,0,0,0,0,0,0,0,0,0,0
"300 block beard av w, Syracuse, NY",65,3,21,5,39,3,1,0,1,0,1,0,0,20,41,1,0,0,1,2,203,12,16,12,11,9,2,3,26,9,17,39,29,10,0,3
"300 block beattie st, Syracuse, NY",31,6,5,3,23,6,4,0,0,0,2,0,0,14,15,0,0,0,1,1,57,14,11,3,3,0,0,0,8,2,6,23,7,16,3,3
"300 block beech st s, Syracuse, NY",83,5,2,2,79,5,0,0,0,0,0,0,5,39,39,0,3,0,0,2,115,65,10,4,2,2,0,0,4,1,3,79,7,72,1,4
"300 block beecher st, Syracuse, NY",62,11,15,2,45,11,2,0,4,0,0,0,5,40,15,0,1,0,3,3,147,21,21,9,5,3,1,2,17,6,11,45,16,29,0,11
"300 block brighton av e, Syracuse, NY",36,4,0,1,35,4,4,0,0,0,0,0,0,27,4,0,4,0,0,1,90,9,13,6,4,3,1,0,1,0,1,35,3,32,0,4
"300 block broad st, Syracuse, NY",28,2,7,3,18,2,0,0,0,0,0,0,2,2,24,0,0,0,2,0,100,4,6,3,7,4,3,1,10,1,9,18,16,2,0,2
"300 block bryant av, Syracuse, NY",5,0,1,2,2,0,0,0,0,0,0,0,0,5,0,0,0,0,0,0,10,2,1,2,0,0,0,0,3,1,2,2,1,1,0,0
"300 block burdick av, Syracuse, NY",17,2,1,2,14,2,0,0,0,0,0,0,2,15,0,0,0,0,2,0,28,10,5,0,2,0,0,0,3,0,3,14,3,11,0,2
"300 block burnet av, Syracuse, NY",0,0,0,0,0,0,0,0,0,0,0,0,0,0,0,0,0,0,0,0,0,0,0,0,0,0,0,0,0,0,0,0,0,0,0,0
"300 block burt st, Syracuse, NY",0,0,0,0,0,0,0,0,0,0,0,0,0,0,0,0,0,0,0,0,0,0,0,0,0,0,0,0,0,0,0,0,0,0,0,0
"300 block calthrop av w, Syracuse, NY",23,2,2,1,20,2,0,0,2,0,0,0,0,8,14,1,0,0,0,0,74,6,3,4,6,1,2,1,3,0,3,20,13,7,0,2
"300 block catherine st, Syracuse, NY",57,12,3,3,51,12,7,0,1,0,1,0,3,37,17,1,0,0,0,2,117,25,18,5,5,3,1,0,6,0,6,51,14,37,0,12
"300 block cayuga st, Syracuse, NY",64,8,11,7,46,8,6,1,0,0,0,0,1,59,3,1,1,0,0,0,115,34,14,12,3,1,0,0,18,7,11,46,6,40,2,6
"300 block clairmonte av, Syracuse, NY",0,0,0,0,0,0,0,0,0,0,0,0,0,0,0,0,0,0,0,0,0,0,0,0,0,0,0,0,0,0,0,0,0,0,0,0
"300 block cleveland av, Syracuse, NY",112,9,42,20,50,9,2,0,1,0,0,0,6,99,10,0,0,0,1,2,281,32,36,20,13,6,2,3,62,16,46,50,24,26,1,8
"300 block clinton st s, Syracuse, NY",0,0,0,0,0,0,0,0,0,0,0,0,0,0,0,0,0,0,0,0,0,0,0,0,0,0,0,0,0,0,0,0,0,0,0,0
"300 block collingwood av n, Syracuse, NY",2,0,0,0,2,0,0,0,0,0,0,0,0,0,2,0,0,0,0,0,9,0,0,1,0,0,1,0,0,0,0,2,1,1,0,0
"300 block comstock av, Syracuse, NY",0,0,0,0,0,0,0,0,0,0,0,0,0,0,0,0,0,0,0,0,0,0,0,0,0,0,0,0,0,0,0,0,0,0,0,0
"300 block coolidge av, Syracuse, NY",41,15,12,4,25,15,1,0,0,2,2,0,10,2,33,0,0,0,3,3,131,6,9,8,11,4,2,1,16,9,7,25,14,11,0,15
"300 block cortland av, Syracuse, NY",0,0,0,0,0,0,0,0,0,0,0,0,0,0,0,0,0,0,0,0,0,0,0,0,0,0,0,0,0,0,0,0,0,0,0,0
"300 block court st, Syracuse, NY",0,0,0,0,0,0,0,0,0,0,0,0,0,0,0,0,0,0,0,0,0,0,0,0,0,0,0,0,0,0,0,0,0,0,0,0
"300 block craig st, Syracuse, NY",70,16,7,8,55,16,11,1,2,0,0,0,2,28,26,1,10,0,1,4,224,19,12,12,8,12,1,6,15,5,10,55,30,25,0,16
"300 block crawford av, Syracuse, NY",29,1,16,9,4,1,0,0,0,0,0,0,1,28,1,0,0,0,0,0,57,9,15,2,3,0,0,0,25,4,21,4,1,3,0,1
"300 block crossett st, Syracuse, NY",20,0,15,5,0,0,0,0,0,0,0,0,0,18,2,0,0,0,0,0,57,1,10,3,4,1,1,0,20,7,13,0,0,0,0,0
"300 block crouse av n, Syracuse, NY",3,2,0,0,3,2,2,0,0,0,0,0,0,0,1,0,1,0,0,1,3,3,0,0,0,0,0,0,0,0,0,3,0,3,0,2
"300 block crouse av s, Syracuse, NY",8,2,4,2,2,2,0,0,0,0,0,0,2,4,3,0,0,0,0,1,18,5,1,0,1,0,0,1,6,2,4,2,0,2,0,2
"300 block darlington rd, Syracuse, NY",26,0,13,3,10,0,0,0,0,0,0,0,0,24,1,0,0,0,0,1,60,9,7,7,1,1,0,1,16,3,13,10,4,6,0,0
"300 block delaware st, Syracuse, NY",106,11,13,7,86,11,0,1,0,0,0,0,10,31,55,5,1,0,8,6,292,32,26,20,7,12,4,5,20,5,15,86,45,41,1,10
"300 block dewitt st, Syracuse, NY",22,6,14,6,2,6,0,0,2,0,3,0,1,20,1,0,1,0,0,0,40,8,12,1,0,1,0,0,20,2,18,2,0,2,0,6
"300 block division st e, Syracuse, NY",14,4,3,2,9,4,1,0,1,0,1,0,1,7,6,0,0,0,1,0,55,3,3,1,1,2,1,3,5,0,5,9,7,2,0,4
"300 block erie blvd e, Syracuse, NY",57,4,0,0,57,4,3,0,0,0,1,0,0,42,4,0,8,0,0,3,69,46,10,1,0,0,0,0,0,0,0,57,0,57,0,4
"300 block erie st, Syracuse, NY",106,7,14,8,84,7,7,0,0,0,0,0,0,82,15,2,0,0,2,5,195,50,36,10,7,3,0,0,22,6,16,84,16,68,0,7
"300 block essex st, Syracuse, NY",12,0,5,1,6,0,0,0,0,0,0,0,0,10,1,0,0,0,0,1,23,5,5,1,0,1,0,0,6,0,6,6,2,4,0,0
"300 block euclid av, Syracuse, NY",43,1,3,5,35,1,0,0,0,0,0,0,1,34,2,0,5,0,0,2,116,5,10,22,5,1,0,0,8,1,7,35,3,32,1,0
"300 block eureka st, Syracuse, NY",95,26,15,18,62,26,12,0,0,0,0,0,14,64,25,1,0,0,3,2,273,25,22,21,12,8,3,4,33,6,27,62,38,24,1,25
"300 block fayette blvd w, Syracuse, NY",90,24,16,7,67,24,20,0,0,0,0,0,4,67,19,0,2,0,1,1,163,45,26,12,5,2,0,0,23,6,17,67,15,52,0,24
"300 block fayette st e, Syracuse, NY",45,5,18,8,19,5,2,0,2,0,0,0,1,41,3,0,1,0,0,0,103,19,9,8,6,1,1,1,26,6,20,19,5,14,0,5
"300 block fayette st w, Syracuse, NY",65,5,18,8,39,5,4,0,0,0,0,0,1,57,7,0,0,0,0,1,100,42,13,8,2,0,0,0,26,1,25,39,5,34,0,5
"300 block fellows av, Syracuse, NY",30,1,18,10,2,1,0,0,0,0,0,0,1,24,5,0,1,0,0,0,59,10,14,3,3,0,0,0,28,6,22,2,1,1,0,1
"300 block first north st, Syracuse, NY",20,0,11,4,5,0,0,0,0,0,0,0,0,12,4,0,3,0,1,0,59,3,10,1,2,3,0,1,15,4,11,5,3,2,0,0
"300 block florence av e, Syracuse, NY",34,6,19,7,8,6,3,0,0,0,0,0,3,32,1,0,1,0,0,0,83,12,9,4,5,3,1,0,26,6,20,8,2,6,0,6
"300 block forest hill dr, Syracuse, NY",41,3,25,6,10,3,0,0,2,0,1,0,0,37,2,0,2,0,0,0,85,19,11,5,2,3,1,0,31,5,26,10,1,9,0,3
"300 block garfield av, Syracuse, NY",24,2,5,8,11,2,0,0,0,0,0,0,2,0,24,0,0,0,0,0,70,5,7,3,6,1,1,1,13,4,9,11,4,7,0,2
"300 block geddes st s, Syracuse, NY",73,8,21,6,46,8,4,1,0,0,0,0,3,59,10,1,1,0,0,2,135,37,20,8,6,2,0,0,27,7,20,46,5,41,0,8
"300 block genesee park dr, Syracuse, NY",15,3,10,3,2,3,2,0,0,0,0,0,1,9,6,0,0,0,0,0,28,7,6,1,0,0,1,0,13,1,12,2,1,1,0,3
"300 block genesee st w, Syracuse, NY",76,5,37,24,15,5,0,0,1,0,0,0,4,70,4,0,0,0,0,2,164,28,22,17,6,2,0,1,61,13,48,15,5,10,0,5
"300 block gertrude st, Syracuse, NY",17,11,5,3,9,11,0,0,9,0,0,0,2,13,2,0,0,0,0,2,47,6,4,1,1,4,1,0,8,2,6,9,4,5,0,11
"300 block gifford st, Syracuse, NY",33,24,0,0,33,24,12,0,0,0,0,0,12,15,15,0,0,0,2,1,52,21,7,3,2,0,0,0,0,0,0,33,7,26,0,24
"300 block goodrich av, Syracuse, NY",13,0,0,0,13,0,0,0,0,0,0,0,0,8,1,0,2,0,0,2,26,1,11,1,0,0,0,0,0,0,0,13,0,13,0,0
"300 block grant av, Syracuse, NY",0,0,0,0,0,0,0,0,0,0,0,0,0,0,0,0,0,0,0,0,0,0,0,0,0,0,0,0,0,0,0,0,0,0,0,0
"300 block greenwood pl, Syracuse, NY",119,14,8,5,106,14,10,0,0,0,2,0,2,83,17,3,12,0,1,3,322,30,28,25,24,9,2,1,13,2,11,106,6,100,1,13
"300 block hamilton st, Syracuse, NY",60,4,14,6,40,4,3,0,0,0,0,0,1,57,2,0,0,0,1,0,131,28,14,5,7,4,2,0,20,5,15,40,12,28,0,4
"300 block hartson st, Syracuse, NY",178,23,10,13,155,23,2,1,4,2,0,0,14,124,34,1,2,0,10,7,349,115,14,18,13,11,5,2,23,7,16,155,39,116,1,22
"300 block hawley av, Syracuse, NY",0,0,0,0,0,0,0,0,0,0,0,0,0,0,0,0,0,0,0,0,0,0,0,0,0,0,0,0,0,0,0,0,0,0,0,0
"300 block helen st, Syracuse, NY",69,3,25,19,25,3,1,0,1,0,0,0,1,62,5,0,0,0,0,2,156,23,23,9,11,2,1,0,44,7,37,25,10,15,0,3
"300 block herkimer st, Syracuse, NY",57,3,16,10,31,3,1,0,0,0,0,0,2,52,4,0,0,0,0,1,145,17,16,9,9,5,0,1,26,6,20,31,14,17,0,3
"300 block hiawatha blvd w, Syracuse, NY",7,0,0,0,7,0,0,0,0,0,0,0,0,3,3,0,0,0,1,0,15,3,1,2,1,0,0,0,0,0,0,7,3,4,0,0
"300 block hiawatha blvd, Syracuse, NY",0,0,0,0,0,0,0,0,0,0,0,0,0,0,0,0,0,0,0,0,0,0,0,0,0,0,0,0,0,0,0,0,0,0,0,0
"300 block hickok av, Syracuse, NY",80,3,16,7,57,3,2,0,1,0,0,0,0,67,11,0,1,0,0,1,185,25,27,14,9,4,0,1,23,6,17,57,20,37,0,3
"300 block hillsdale av, Syracuse, NY",0,0,0,0,0,0,0,0,0,0,0,0,0,0,0,0,0,0,0,0,0,0,0,0,0,0,0,0,0,0,0,0,0,0,0,0
"300 block hixson av, Syracuse, NY",53,11,27,7,19,11,2,1,5,0,0,0,3,46,2,2,2,0,1,0,113,20,19,9,2,0,1,2,34,7,27,19,6,13,0,11
"300 block jamesville av, Syracuse, NY",223,27,11,5,207,27,25,0,0,0,0,0,2,68,101,0,48,0,1,5,469,100,52,34,26,7,4,0,16,3,13,207,74,133,0,27
"300 block jefferson st w, Syracuse, NY",25,2,11,5,9,2,0,0,2,0,0,0,0,23,0,0,0,0,1,1,59,6,9,6,3,1,0,0,16,5,11,9,7,2,1,1
"300 block john st, Syracuse, NY",17,0,6,0,11,0,0,0,0,0,0,0,0,14,1,2,0,0,0,0,40,6,5,3,2,0,0,1,6,1,5,11,5,6,0,0
"300 block kellogg st, Syracuse, NY",12,1,3,0,9,1,1,0,0,0,0,0,0,2,6,1,0,0,2,1,40,2,1,4,2,2,1,0,3,1,2,9,6,3,0,1
"300 block kennedy st w, Syracuse, NY",48,1,19,7,22,1,0,0,0,0,0,0,1,43,5,0,0,0,0,0,102,18,19,3,5,2,0,1,26,9,17,22,4,18,0,1
"300 block kenwood av, Syracuse, NY",24,1,13,10,1,1,0,0,0,0,0,0,1,24,0,0,0,0,0,0,53,7,8,6,3,0,0,0,23,3,20,1,0,1,0,1
"300 block kirkpatrick st w, Syracuse, NY",57,2,33,17,7,2,0,0,0,0,0,0,2,56,1,0,0,0,0,0,111,23,21,7,5,1,0,0,50,8,42,7,3,4,0,2
"300 block kramer dr, Syracuse, NY",24,0,17,6,1,0,0,0,0,0,0,0,0,18,6,0,0,0,0,0,47,8,13,0,2,1,0,0,23,4,19,1,1,0,0,0
"300 block lemoyne av, Syracuse, NY",15,0,2,1,12,0,0,0,0,0,0,0,0,7,7,0,0,0,1,0,47,5,1,2,5,1,0,1,3,1,2,12,8,4,0,0
"300 block lennox av, Syracuse, NY",70,1,42,8,20,1,0,0,0,0,0,0,1,62,3,0,2,0,1,2,175,16,24,17,6,6,1,0,50,17,33,20,5,15,0,1
"300 block lewis st, Syracuse, NY",112,13,29,13,70,13,7,1,0,1,1,0,3,97,9,2,0,0,1,3,200,63,28,8,9,3,1,0,42,7,35,70,11,59,1,12
"300 block lewiston dr, Syracuse, NY",0,0,0,0,0,0,0,0,0,0,0,0,0,0,0,0,0,0,0,0,0,0,0,0,0,0,0,0,0,0,0,0,0,0,0,0
"300 block lexington av, Syracuse, NY",60,12,2,2,56,12,10,0,0,0,0,0,2,15,43,0,0,0,2,0,112,34,10,11,2,1,2,0,4,1,3,56,17,39,1,11
"300 block loma av, Syracuse, NY",35,1,25,8,2,1,0,0,0,0,0,0,1,32,1,0,2,0,0,0,90,8,10,9,6,1,1,0,33,11,22,2,2,0,0,1
"300 block lowell av s, Syracuse, NY",57,3,30,12,15,3,1,0,0,0,0,0,2,52,2,0,1,0,0,2,118,19,25,5,6,2,0,0,42,7,35,15,2,13,0,3
"300 block lynch av, Syracuse, NY",18,0,11,6,1,0,0,0,0,0,0,0,0,17,1,0,0,0,0,0,52,2,6,5,2,3,0,0,17,6,11,1,1,0,0,0
"300 block marcellus st, Syracuse, NY",0,0,0,0,0,0,0,0,0,0,0,0,0,0,0,0,0,0,0,0,0,0,0,0,0,0,0,0,0,0,0,0,0,0,0,0
"300 block marshall st, Syracuse, NY",0,0,0,0,0,0,0,0,0,0,0,0,0,0,0,0,0,0,0,0,0,0,0,0,0,0,0,0,0,0,0,0,0,0,0,0
"300 block mcbride st n, Syracuse, NY",32,1,20,9,3,1,0,0,0,0,0,0,1,25,3,1,2,0,0,1,82,6,14,6,3,1,1,1,29,9,20,3,1,2,0,1
"300 block merritt av, Syracuse, NY",81,1,49,14,18,1,1,0,0,0,0,0,0,67,7,2,1,0,0,4,183,28,28,11,9,4,0,1,63,13,50,18,4,14,0,1
"300 block mertens av, Syracuse, NY",37,2,20,13,4,2,0,0,0,1,0,0,1,37,0,0,0,0,0,0,78,10,17,7,2,1,0,0,33,6,27,4,1,3,0,2
"300 block midler av s, Syracuse, NY",140,3,57,27,56,3,1,0,2,0,0,0,0,127,11,0,1,0,1,0,304,46,50,28,9,4,3,0,84,19,65,56,15,41,0,3
"300 block montgomery st, Syracuse, NY",9,11,1,0,8,11,11,0,0,0,0,0,0,7,1,0,1,0,0,0,13,5,4,0,0,0,0,0,1,0,1,8,0,8,0,11
"300 block mount olympus dr, Syracuse, NY",48,1,7,5,36,1,0,0,0,0,0,0,1,42,2,0,3,0,0,1,166,3,10,18,7,3,4,3,12,4,8,36,0,36,0,1
"300 block mountainview av, Syracuse, NY",190,13,36,15,139,13,6,0,2,1,0,0,4,120,57,2,2,0,1,8,326,118,45,7,8,9,1,2,51,14,37,139,13,126,1,12
"300 block newell st w, Syracuse, NY",119,14,19,4,96,14,9,1,0,0,1,0,3,95,14,1,1,0,4,4,199,73,25,10,10,0,1,0,23,6,17,96,16,80,0,14
"300 block north av, Syracuse, NY",64,3,14,4,46,3,3,0,0,0,0,0,0,52,11,0,0,0,0,1,123,34,13,11,2,2,2,0,18,7,11,46,8,38,0,3
"300 block nottingham rd, Syracuse, NY",83,5,40,27,16,5,3,0,0,0,0,0,2,71,8,1,2,0,1,0,179,23,35,16,8,0,1,0,67,13,54,16,3,13,0,5
"300 block oak st, Syracuse, NY",70,4,20,8,42,4,0,0,0,0,0,0,4,54,12,1,0,0,0,3,184,21,18,11,12,4,3,1,28,8,20,42,16,26,0,4
"300 block onondaga av, Syracuse, NY",27,7,4,5,18,7,2,0,0,0,0,0,5,2,24,0,0,0,1,0,53,15,6,2,2,0,2,0,9,3,6,18,6,12,0,7
"300 block onondaga st e, Syracuse, NY",21,3,14,1,6,3,0,0,0,0,0,0,3,17,1,0,0,0,2,1,49,7,5,5,3,1,0,0,15,4,11,6,2,4,0,3
"300 block onondaga st w, Syracuse, NY",35,1,22,11,2,1,0,0,0,0,0,0,1,33,1,0,0,0,0,1,79,8,16,6,4,1,0,0,33,8,25,2,0,2,0,1
"300 block ostrander av w, Syracuse, NY",60,7,17,5,38,7,7,0,0,0,0,0,0,8,47,0,1,0,2,2,177,15,14,11,8,8,2,2,22,6,16,38,21,17,0,7
"300 block ostrom av, Syracuse, NY",38,2,1,0,37,2,2,0,0,0,0,0,0,9,27,0,0,0,0,2,86,19,5,6,4,2,1,1,1,0,1,37,14,23,0,2
"300 block ostrum av, Syracuse, NY",70,2,1,0,69,2,2,0,0,0,0,0,0,14,53,0,0,0,0,3,201,26,8,11,12,5,4,4,1,0,1,69,39,30,0,2
"300 block overlook dr, Syracuse, NY",42,3,25,8,9,3,0,0,0,0,0,0,3,38,3,1,0,0,0,0,92,17,13,2,8,1,1,0,33,7,26,9,2,7,1,2
"300 block pacific av, Syracuse, NY",55,5,31,18,6,5,0,0,1,1,1,0,2,36,17,1,0,0,0,1,122,14,24,11,4,1,1,0,49,12,37,6,2,4,0,5
"300 block park st, Syracuse, NY",365,27,9,6,350,27,12,1,0,0,3,0,11,252,75,5,21,0,2,10,481,283,60,11,10,1,0,0,15,2,13,350,21,329,0,27
"300 block pine st, Syracuse, NY",0,0,0,0,0,0,0,0,0,0,0,0,0,0,0,0,0,0,0,0,0,0,0,0,0,0,0,0,0,0,0,0,0,0,0,0
"300 block pleasant av w, Syracuse, NY",139,36,52,13,74,36,19,0,1,8,0,0,8,19,104,3,0,0,4,9,462,25,27,32,27,12,4,12,65,27,38,74,50,24,3,33
"300 block pond st, Syracuse, NY",150,31,21,17,112,31,12,0,2,0,1,0,16,73,31,0,29,0,9,8,479,42,26,28,15,18,10,11,38,12,26,112,65,47,0,31
"300 block prospect av, Syracuse, NY",26,14,0,0,26,14,14,0,0,0,0,0,0,10,14,0,1,0,1,0,31,22,3,1,0,0,0,0,0,0,0,26,3,23,0,14
"300 block pulaski st, Syracuse, NY",0,0,0,0,0,0,0,0,0,0,0,0,0,0,0,0,0,0,0,0,0,0,0,0,0,0,0,0,0,0,0,0,0,0,0,0
"300 block putnam st, Syracuse, NY",44,15,7,4,33,15,10,0,0,2,0,0,3,20,18,2,1,0,0,3,123,14,9,12,2,1,3,3,11,2,9,33,15,18,0,15
"300 block renwick av, Syracuse, NY",0,0,0,0,0,0,0,0,0,0,0,0,0,0,0,0,0,0,0,0,0,0,0,0,0,0,0,0,0,0,0,0,0,0,0,0
"300 block rich st, Syracuse, NY",12,4,6,3,3,4,0,0,0,2,0,0,2,6,5,0,0,0,0,1,41,2,2,3,2,1,1,1,9,5,4,3,2,1,0,4
"300 block richmond av, Syracuse, NY",0,7,0,0,0,7,4,0,0,0,0,0,3,0,0,0,0,0,0,0,0,0,0,0,0,0,0,0,0,0,0,0,0,0,0,7
"300 block riegel st, Syracuse, NY",29,2,5,2,22,2,1,0,0,0,0,0,1,18,6,2,1,0,0,2,56,14,8,4,1,2,0,0,7,1,6,22,6,16,0,2
"300 block rill av, Syracuse, NY",22,4,7,2,13,4,0,0,0,0,0,0,4,8,13,0,0,0,0,1,67,1,9,6,3,0,3,0,9,5,4,13,11,2,0,4
"300 block salina st s, Syracuse, NY",73,14,24,13,36,14,8,0,0,0,0,0,6,18,48,1,0,0,4,2,230,11,22,16,10,4,4,6,37,11,26,36,19,17,0,14
"300 block salt springs rd, Syracuse, NY",23,0,17,6,0,0,0,0,0,0,0,0,0,19,2,0,0,0,0,2,48,7,11,2,2,1,0,0,23,5,18,0,0,0,0,0
"300 block sand st, Syracuse, NY",19,4,2,2,15,4,0,2,0,0,0,0,2,17,2,0,0,0,0,0,32,8,9,2,0,0,0,0,4,0,4,15,3,12,0,4
"300 block seymour st, Syracuse, NY",107,18,15,14,78,18,10,1,0,0,0,0,7,40,45,0,1,0,14,7,247,44,28,16,9,4,1,5,29,9,20,78,21,57,0,18
"300 block shonnard st, Syracuse, NY",31,2,7,4,20,2,0,0,0,0,0,0,2,13,12,0,1,0,4,1,96,8,7,4,5,2,3,2,11,7,4,20,11,9,0,2
"300 block shuart av, Syracuse, NY",91,7,36,23,32,7,3,1,1,0,0,0,2,80,5,3,0,0,0,3,190,30,38,11,11,0,0,1,59,12,47,32,5,27,2,5
"300 block small rd, Syracuse, NY",65,2,32,8,25,2,2,0,0,0,0,0,0,59,2,0,3,0,0,1,134,21,25,14,4,1,0,0,40,14,26,25,2,23,1,1
"300 block south av, Syracuse, NY",12,3,2,3,7,3,2,0,0,0,0,0,1,0,10,0,0,0,1,1,49,0,1,5,2,2,1,1,5,2,3,7,7,0,0,3
"300 block springfield rd, Syracuse, NY",7,1,0,5,2,1,0,0,0,0,0,0,1,7,0,0,0,0,0,0,12,3,3,1,0,0,0,0,5,0,5,2,0,2,0,1
"300 block stadium pl, Syracuse, NY",8,0,0,0,8,0,0,0,0,0,0,0,0,4,1,0,2,0,0,1,24,1,1,4,1,1,0,0,0,0,0,8,0,8,0,0
"300 block stafford av, Syracuse, NY",39,0,17,9,13,0,0,0,0,0,0,0,0,34,2,1,0,0,0,2,84,13,12,10,3,1,0,0,26,7,19,13,3,10,0,0
"300 block state st s, Syracuse, NY",0,0,0,0,0,0,0,0,0,0,0,0,0,0,0,0,0,0,0,0,0,0,0,0,0,0,0,0,0,0,0,0,0,0,0,0
"300 block sterling av, Syracuse, NY",27,3,5,4,18,3,2,0,0,0,0,0,1,0,27,0,0,0,0,0,78,6,8,5,4,1,2,1,9,4,5,18,8,10,0,3
"300 block sunset av, Syracuse, NY",41,7,5,3,33,7,2,0,5,0,0,0,0,30,6,0,2,0,1,2,82,17,15,6,1,0,1,1,8,2,6,33,8,25,0,7
"300 block tennyson av, Syracuse, NY",112,2,35,13,64,2,2,0,0,0,0,0,0,105,4,1,1,0,0,1,242,37,36,27,8,4,0,0,48,15,33,64,9,55,0,2
"300 block tioga st, Syracuse, NY",118,26,13,7,98,26,14,1,1,1,3,0,6,56,40,1,2,0,15,4,318,41,27,13,21,8,2,6,20,10,10,98,47,51,1,25
"300 block tracy st, Syracuse, NY",0,0,0,0,0,0,0,0,0,0,0,0,0,0,0,0,0,0,0,0,0,0,0,0,0,0,0,0,0,0,0,0,0,0,0,0
"300 block tully st, Syracuse, NY",27,6,0,2,25,6,2,0,0,2,0,0,2,8,14,0,0,0,3,2,74,4,8,7,7,1,0,0,2,0,2,25,14,11,0,6
"300 block university pl, Syracuse, NY",0,0,0,0,0,0,0,0,0,0,0,0,0,0,0,0,0,0,0,0,0,0,0,0,0,0,0,0,0,0,0,0,0,0,0,0
"300 block valley dr, Syracuse, NY",9,5,1,1,7,5,0,0,0,0,0,0,5,2,7,0,0,0,0,0,28,1,3,3,0,1,0,1,2,1,1,7,4,3,0,5
"300 block vann st, Syracuse, NY",38,6,5,8,25,6,1,0,0,1,0,0,4,32,6,0,0,0,0,0,82,13,13,7,4,0,1,0,13,2,11,25,8,17,0,6
"300 block vincent st, Syracuse, NY",0,0,0,0,0,0,0,0,0,0,0,0,0,0,0,0,0,0,0,0,0,0,0,0,0,0,0,0,0,0,0,0,0,0,0,0
"300 block walnut pl, Syracuse, NY",65,0,0,1,64,0,0,0,0,0,0,0,0,53,0,1,11,0,0,0,140,23,19,15,7,0,1,0,1,0,1,64,0,64,0,0
"300 block warner av, Syracuse, NY",16,6,4,1,11,6,0,0,2,0,0,0,4,5,11,0,0,0,0,0,47,4,2,2,7,1,0,0,5,2,3,11,7,4,0,6
"300 block warren st s, Syracuse, NY",476,8,0,1,475,8,1,2,0,0,2,0,3,254,36,2,170,0,3,11,668,315,138,15,8,0,0,0,1,0,1,475,19,456,0,8
"300 block washington st w, Syracuse, NY",0,0,0,0,0,0,0,0,0,0,0,0,0,0,0,0,0,0,0,0,0,0,0,0,0,0,0,0,0,0,0,0,0,0,0,0
"300 block waverly av, Syracuse, NY",20,1,1,2,17,1,0,0,0,0,0,0,1,20,0,0,0,0,0,0,99,2,1,1,3,3,7,3,3,0,3,17,0,17,0,1
"300 block webster st, Syracuse, NY",55,8,16,6,33,8,2,0,0,0,0,0,6,6,44,0,0,0,3,2,177,13,12,10,8,3,4,5,22,8,14,33,20,13,0,8
"300 block westcott st, Syracuse, NY",58,8,9,3,46,8,7,0,1,0,0,0,0,22,31,0,2,0,1,2,158,12,19,12,7,5,2,1,12,2,10,46,21,25,0,8
"300 block wilkinson st, Syracuse, NY",0,0,0,0,0,0,0,0,0,0,0,0,0,0,0,0,0,0,0,0,0,0,0,0,0,0,0,0,0,0,0,0,0,0,0,0
"300 block willow st e, Syracuse, NY",7,7,0,0,7,7,1,0,0,0,0,0,6,5,2,0,0,0,0,0,11,4,2,1,0,0,0,0,0,0,0,7,1,6,0,7
"300 block wilson st, Syracuse, NY",45,9,13,6,26,9,0,0,0,0,1,0,8,42,2,0,0,0,0,1,96,16,15,9,3,1,1,0,19,2,17,26,8,18,0,9
"300 block winton st, Syracuse, NY",71,11,22,11,38,11,7,0,0,1,0,0,3,54,11,2,1,0,1,2,184,22,17,12,11,6,3,0,33,10,23,38,20,18,0,11
"300 block wodbine av, Syracuse, NY",49,1,21,8,20,1,1,0,0,0,0,0,0,43,6,0,0,0,0,0,99,19,19,7,1,1,2,0,29,6,23,20,7,13,0,1
"300 block woodruff av, Syracuse, NY",41,3,12,9,20,3,1,0,0,0,0,0,2,38,1,0,1,0,0,1,80,17,16,5,2,0,0,1,21,2,19,20,4,16,0,3
"3000 block genesee st e, Syracuse, NY",0,0,0,0,0,0,0,0,0,0,0,0,0,0,0,0,0,0,0,0,0,0,0,0,0,0,0,0,0,0,0,0,0,0,0,0
"3000 block james st, Syracuse, NY",95,4,33,14,48,4,3,0,0,0,0,0,1,73,17,0,0,0,0,5,206,36,32,12,8,5,1,1,47,18,29,48,12,36,0,4
"3000 block midland av, Syracuse, NY",8,1,5,1,2,1,0,0,0,1,0,0,0,5,2,0,0,0,0,1,13,4,3,1,0,0,0,0,6,0,6,2,1,1,0,1
"3100 block brighton av e, Syracuse, NY",23,1,8,13,2,1,0,0,1,0,0,0,0,22,0,0,0,0,1,0,40,14,5,1,2,1,0,0,21,2,19,2,1,1,0,1
"3100 block erie blvd e, Syracuse, NY",13,1,8,4,1,1,0,0,1,0,0,0,0,10,3,0,0,0,0,0,32,3,6,2,1,0,0,1,12,3,9,1,1,0,0,1
"3100 block genesee st e, Syracuse, NY",0,0,0,0,0,0,0,0,0,0,0,0,0,0,0,0,0,0,0,0,0,0,0,0,0,0,0,0,0,0,0,0,0,0,0,0
"3200 block brighton pl, Syracuse, NY",12,0,6,4,2,0,0,0,0,0,0,0,0,8,3,0,0,0,0,1,33,1,5,3,2,1,0,0,10,2,8,2,2,0,0,0
"3300 block burnet av, Syracuse, NY",30,1,19,5,6,1,0,0,0,0,1,0,0,5,24,0,1,0,0,0,88,4,11,6,4,3,1,1,24,8,16,6,2,4,0,1
"3300 block james st, Syracuse, NY",19,1,11,5,3,1,0,0,0,0,1,0,0,17,0,0,0,0,0,2,35,8,7,3,1,0,0,0,16,2,14,3,0,3,0,1
"3300 block midland av, Syracuse, NY",37,2,27,8,2,2,0,0,0,0,0,0,2,19,13,3,1,0,0,1,97,11,9,9,3,3,1,1,35,11,24,2,1,1,1,1
"3400 block burnet av, Syracuse, NY",0,0,0,0,0,0,0,0,0,0,0,0,0,0,0,0,0,0,0,0,0,0,0,0,0,0,0,0,0,0,0,0,0,0,0,0
"3400 block james st, Syracuse, NY",84,3,28,16,40,3,2,0,0,0,0,0,1,74,6,0,3,0,0,1,153,42,31,5,3,0,0,3,44,6,38,40,7,33,0,3
"3400 block salina st s, Syracuse, NY",25,10,4,0,21,10,3,0,1,0,0,0,6,6,17,0,0,0,0,2,80,7,5,4,4,2,1,2,4,2,2,21,9,12,0,10
"3600 block james st, Syracuse, NY",31,4,17,10,4,4,0,0,1,2,1,0,0,30,1,0,0,0,0,0,76,8,10,5,7,1,0,0,27,9,18,4,0,4,0,4
"3600 block midland av, Syracuse, NY",20,1,8,3,9,1,0,0,1,0,0,0,0,8,12,0,0,0,0,0,52,6,6,3,2,1,2,0,11,4,7,9,5,4,0,1
"3700 block midland av, Syracuse, NY",13,0,5,3,5,0,0,0,0,0,0,0,0,8,4,1,0,0,0,0,25,7,2,2,2,0,0,0,8,1,7,5,1,4,0,0
"3700 block salina st s, Syracuse, NY",14,2,9,4,1,2,1,0,0,0,0,0,1,6,8,0,0,0,0,0,21,8,5,1,0,0,0,0,13,0,13,1,0,1,0,2
"3800 block salina st s, Syracuse, NY",0,0,0,0,0,0,0,0,0,0,0,0,0,0,0,0,0,0,0,0,0,0,0,0,0,0,0,0,0,0,0,0,0,0,0,0
"400 block alvord st s, Syracuse, NY",43,13,3,2,38,13,5,1,0,0,0,0,7,22,14,2,4,0,1,0,136,11,10,4,9,3,3,3,5,3,2,38,20,18,0,13
"400 block arthur st, Syracuse, NY",27,5,6,4,17,5,4,0,0,0,0,0,1,13,8,0,0,0,4,2,64,8,8,7,2,1,1,0,10,1,9,17,8,9,0,5
"400 block avery av, Syracuse, NY",9,0,1,2,6,0,0,0,0,0,0,0,0,8,0,1,0,0,0,0,31,2,0,3,2,1,0,1,3,2,1,6,4,2,0,0
"400 block bear st, Syracuse, NY",83,23,9,5,69,23,9,0,2,0,0,0,12,54,14,4,1,0,2,8,239,23,21,13,11,7,1,7,14,4,10,69,36,33,4,19
"400 block beattie st, Syracuse, NY",80,11,22,17,41,11,9,0,2,0,0,0,0,15,61,2,0,0,1,1,202,23,23,16,12,3,1,2,39,9,30,41,22,19,0,11
"400 block beech st s, Syracuse, NY",52,8,8,6,38,8,1,0,0,2,0,0,5,29,11,0,9,0,0,3,130,21,13,7,2,5,1,3,14,6,8,38,11,27,0,8
"400 block bellevue av, Syracuse, NY",0,0,0,0,0,0,0,0,0,0,0,0,0,0,0,0,0,0,0,0,0,0,0,0,0,0,0,0,0,0,0,0,0,0,0,0
"400 block boyden st, Syracuse, NY",94,9,28,11,55,9,2,1,0,1,0,0,5,76,8,2,2,0,2,4,231,32,25,19,9,3,3,3,39,13,26,55,17,38,0,9
"400 block bradley st, Syracuse, NY",0,0,0,0,0,0,0,0,0,0,0,0,0,0,0,0,0,0,0,0,0,0,0,0,0,0,0,0,0,0,0,0,0,0,0,0
"400 block brighton av e, Syracuse, NY",0,0,0,0,0,0,0,0,0,0,0,0,0,0,0,0,0,0,0,0,0,0,0,0,0,0,0,0,0,0,0,0,0,0,0,0
"400 block brookford rd, Syracuse, NY",78,41,30,15,33,41,38,0,1,2,0,0,0,68,7,0,1,0,1,1,138,42,20,10,4,2,0,0,45,9,36,33,1,32,2,39
"400 block burnet av, Syracuse, NY",0,0,0,0,0,0,0,0,0,0,0,0,0,0,0,0,0,0,0,0,0,0,0,0,0,0,0,0,0,0,0,0,0,0,0,0
"400 block burns av, Syracuse, NY",28,0,13,6,9,0,0,0,0,0,0,0,0,24,0,0,2,0,1,1,61,12,5,9,1,0,0,1,19,5,14,9,1,8,0,0
"400 block butternut st, Syracuse, NY",6,8,0,0,6,8,4,0,0,0,0,0,4,2,1,0,2,0,0,1,9,4,1,1,0,0,0,0,0,0,0,6,1,5,0,8
"400 block carbon st, Syracuse, NY",12,4,6,2,4,4,1,0,0,0,1,0,2,10,0,1,1,0,0,0,36,2,7,0,1,0,1,1,8,3,5,4,0,4,0,4
"400 block cayuga st, Syracuse, NY",1,1,1,0,0,1,0,0,0,0,0,0,1,1,0,0,0,0,0,0,1,1,0,0,0,0,0,0,1,0,1,0,0,0,0,1
"400 block clarence av, Syracuse, NY",2,0,0,2,0,0,0,0,0,0,0,0,0,2,0,0,0,0,0,0,2,2,0,0,0,0,0,0,2,0,2,0,0,0,0,0
"400 block columbus av, Syracuse, NY",19,5,4,5,10,5,3,0,0,2,0,0,0,5,12,0,0,0,2,0,47,6,5,3,3,2,0,0,9,4,5,10,4,6,0,5
"400 block colvin st w, Syracuse, NY",39,7,12,2,25,7,0,0,2,0,0,0,5,3,36,0,0,0,0,0,122,9,8,9,4,3,4,2,14,1,13,25,15,10,0,7
"400 block cortland av, Syracuse, NY",11,0,3,1,7,0,0,0,0,0,0,0,0,0,10,0,0,0,0,1,36,2,1,4,3,0,0,1,4,2,2,7,4,3,0,0
"400 block craddock st, Syracuse, NY",64,4,37,7,20,4,3,0,0,0,0,0,1,47,16,0,0,0,0,1,151,20,20,10,10,3,1,0,44,13,31,20,9,11,0,4
"400 block craig st, Syracuse, NY",96,7,42,29,25,7,0,0,0,0,0,0,7,84,5,0,3,0,2,2,219,36,28,13,11,6,0,2,71,16,55,25,10,15,1,6
"400 block crawford av, Syracuse, NY",36,0,27,5,4,0,0,0,0,0,0,0,0,31,4,0,1,0,0,0,88,4,21,3,7,1,0,0,32,7,25,4,2,2,0,0
"400 block danforth st, Syracuse, NY",56,5,4,2,50,5,1,0,0,0,1,0,3,30,12,1,11,0,0,2,146,17,13,12,7,3,4,0,6,1,5,50,22,28,1,4
"400 block delaware st, Syracuse, NY",55,7,9,4,42,7,6,0,0,0,0,0,1,23,19,1,0,0,10,2,160,13,15,10,7,5,3,2,13,5,8,42,26,16,0,7
"400 block dewitt st, Syracuse, NY",2,0,1,0,1,0,0,0,0,0,0,0,0,2,0,0,0,0,0,0,4,0,2,0,0,0,0,0,1,0,1,1,0,1,0,0
"400 block division st e, Syracuse, NY",98,24,12,18,68,24,13,0,2,0,0,0,9,59,13,2,17,0,5,2,265,32,24,9,17,8,6,2,30,10,20,68,32,36,0,24
"400 block dudley st, Syracuse, NY",33,10,10,1,22,10,9,0,0,0,0,0,1,4,23,0,0,0,4,2,90,10,5,10,5,1,1,1,11,5,6,22,10,12,0,10
"400 block elliott st, Syracuse, NY",32,2,11,8,13,2,2,0,0,0,0,0,0,23,7,0,0,0,0,2,78,7,17,1,2,4,1,0,19,3,16,13,5,8,0,2
"400 block ellis st, Syracuse, NY",53,1,25,8,20,1,0,0,0,0,0,0,1,13,39,0,0,0,0,1,144,13,12,16,5,5,0,2,33,6,27,20,12,8,0,1
"400 block elm st, Syracuse, NY",7,4,0,1,6,4,1,0,0,0,0,0,3,6,1,0,0,0,0,0,26,1,1,2,0,2,0,1,1,0,1,6,5,1,0,4
"400 block emerson av, Syracuse, NY",44,1,12,7,25,1,1,0,0,0,0,0,0,44,0,0,0,0,0,0,82,21,14,5,3,0,1,0,19,1,18,25,2,23,0,1
"400 block erie blvd e, Syracuse, NY",0,0,0,0,0,0,0,0,0,0,0,0,0,0,0,0,0,0,0,0,0,0,0,0,0,0,0,0,0,0,0,0,0,0,0,0
"400 block erie st, Syracuse, NY",43,3,12,7,24,3,1,0,1,0,0,0,1,40,3,0,0,0,0,0,87,22,10,3,5,2,1,0,19,4,15,24,6,18,0,3
"400 block fabius st, Syracuse, NY",7,2,3,0,4,2,2,0,0,0,0,0,0,4,1,0,1,0,0,1,21,3,2,1,0,0,0,1,3,1,2,4,1,3,1,1
"400 block franklin st n, Syracuse, NY",22,6,11,5,6,6,3,0,2,0,0,0,1,20,2,0,0,0,0,0,48,8,7,3,3,1,0,0,16,4,12,6,1,5,0,6
"400 block franklin st s, Syracuse, NY",111,6,51,18,42,6,2,0,1,0,0,0,3,98,10,0,0,0,1,2,238,43,32,18,15,2,0,1,69,20,49,42,14,28,0,6
"400 block genesee pkwy e, Syracuse, NY",0,0,0,0,0,0,0,0,0,0,0,0,0,0,0,0,0,0,0,0,0,0,0,0,0,0,0,0,0,0,0,0,0,0,0,0
"400 block graves st, Syracuse, NY",33,6,5,5,23,6,2,0,0,0,0,0,4,28,3,0,2,0,0,0,91,10,6,8,5,0,3,1,10,2,8,23,10,13,0,6
"400 block hamilton st, Syracuse, NY",119,11,45,16,58,11,4,0,2,0,0,0,5,110,5,1,1,0,2,0,262,42,40,25,4,3,2,3,61,10,51,58,7,51,0,11
"400 block harrison st, Syracuse, NY",0,0,0,0,0,0,0,0,0,0,0,0,0,0,0,0,0,0,0,0,0,0,0,0,0,0,0,0,0,0,0,0,0,0,0,0
"400 block harwood av, Syracuse, NY",30,0,25,5,0,0,0,0,0,0,0,0,0,19,8,0,1,0,1,1,79,6,11,7,2,3,0,1,30,8,22,0,0,0,0,0
"400 block hawley av, Syracuse, NY",61,11,7,2,52,11,7,1,0,0,0,0,3,44,9,0,3,0,3,2,122,27,24,3,4,1,0,2,9,2,7,52,9,43,0,11
"400 block helen st, Syracuse, NY",34,3,24,9,1,3,0,0,1,1,1,0,0,34,0,0,0,0,0,0,77,7,16,6,5,0,0,0,33,8,25,1,0,1,0,3
"400 block hickok av, Syracuse, NY",94,8,16,7,71,8,6,0,1,0,0,0,1,52,35,0,1,0,3,3,231,25,26,24,13,6,0,0,23,8,15,71,36,35,1,7
"400 block highland st, Syracuse, NY",223,23,3,2,218,23,21,2,0,0,0,0,0,153,58,2,3,0,2,5,243,209,10,2,2,0,0,0,5,1,4,218,0,218,0,23
"400 block irving av, Syracuse, NY",12,0,3,3,6,0,0,0,0,0,0,0,0,3,6,0,0,0,2,1,27,4,3,4,0,1,0,0,6,1,5,6,1,5,0,0
"400 block james st, Syracuse, NY",134,40,1,0,133,40,39,0,0,0,0,0,1,90,35,4,3,0,0,2,151,117,17,0,0,0,0,0,1,0,1,133,1,132,0,40
"400 block kimber rd, Syracuse, NY",15,3,10,5,0,3,0,0,0,0,0,0,3,12,2,1,0,0,0,0,31,4,7,3,1,0,0,0,15,1,14,0,0,0,0,3
"400 block kirk av, Syracuse, NY",22,5,2,3,17,5,1,0,1,0,0,0,3,5,14,1,0,0,1,1,63,3,9,5,1,1,3,0,5,2,3,17,10,7,0,5
"400 block kirkpatrick st, Syracuse, NY",41,6,0,1,40,6,4,0,0,0,0,0,2,27,12,0,0,0,1,1,103,10,15,6,6,3,1,0,1,0,1,40,20,20,0,6
"400 block lillian av, Syracuse, NY",48,0,23,7,18,0,0,0,0,0,0,0,0,42,4,1,0,0,0,1,92,20,18,5,4,1,0,0,30,3,27,18,6,12,0,0
"400 block marshall st, Syracuse, NY",123,0,0,0,123,0,0,0,0,0,0,0,0,102,1,0,20,0,0,0,309,26,41,33,16,6,0,1,0,0,0,123,0,123,0,0
"400 block merriman av, Syracuse, NY",26,4,2,5,19,4,1,0,0,0,0,0,3,13,7,0,0,0,4,2,99,5,3,6,4,3,2,3,7,3,4,19,15,4,1,3
"400 block midler av s, Syracuse, NY",45,2,0,0,45,2,2,0,0,0,0,0,0,16,26,0,0,0,0,3,75,25,14,4,0,2,0,0,0,0,0,45,13,32,0,2
"400 block onondaga st w, Syracuse, NY",0,0,0,0,0,0,0,0,0,0,0,0,0,0,0,0,0,0,0,0,0,0,0,0,0,0,0,0,0,0,0,0,0,0,0,0
"400 block oswego st, Syracuse, NY",158,13,5,3,150,13,7,0,0,0,0,0,6,47,82,7,0,1,16,5,291,96,31,14,6,7,0,4,8,1,7,150,26,124,1,12
"400 block otisco st, Syracuse, NY",45,1,0,4,41,1,0,0,0,0,0,0,1,10,31,1,0,0,3,0,149,2,16,12,9,0,2,4,4,0,4,41,33,8,0,1
"400 block park st, Syracuse, NY",122,11,16,6,100,11,6,0,0,0,0,0,5,84,24,0,9,0,3,2,324,38,30,26,13,7,2,6,22,6,16,100,47,53,0,11
"400 block raynor av e, Syracuse, NY",0,0,0,0,0,0,0,0,0,0,0,0,0,0,0,0,0,0,0,0,0,0,0,0,0,0,0,0,0,0,0,0,0,0,0,0
"400 block rich st, Syracuse, NY",15,4,3,3,9,4,0,1,0,1,0,0,2,2,12,0,0,0,0,1,41,3,7,1,2,0,1,1,6,0,6,9,4,5,0,4
"400 block richmond av, Syracuse, NY",26,4,4,4,18,4,2,0,0,0,0,0,2,23,1,0,0,0,1,1,57,7,12,4,1,2,0,0,8,1,7,18,6,12,0,4
"400 block ridgewood dr, Syracuse, NY",27,1,19,6,2,1,1,0,0,0,0,0,0,26,1,0,0,0,0,0,60,12,5,5,2,3,0,0,25,6,19,2,1,1,0,1
"400 block roberts av, Syracuse, NY",50,4,27,9,14,4,1,1,2,0,0,0,0,38,9,0,0,0,0,3,132,11,19,6,8,5,0,1,36,13,23,14,8,6,0,4
"400 block robineau rd, Syracuse, NY",34,4,21,5,8,4,0,0,1,0,0,0,3,23,9,0,0,0,0,2,98,7,7,9,7,2,2,0,26,11,15,8,7,1,0,4
"400 block roosevelt av, Syracuse, NY",16,0,6,8,2,0,0,0,0,0,0,0,0,15,1,0,0,0,0,0,31,5,9,1,0,1,0,0,14,1,13,2,1,1,0,0
"400 block salina st n, Syracuse, NY",0,0,0,0,0,0,0,0,0,0,0,0,0,0,0,0,0,0,0,0,0,0,0,0,0,0,0,0,0,0,0,0,0,0,0,0
"400 block salina st s, Syracuse, NY",0,0,0,0,0,0,0,0,0,0,0,0,0,0,0,0,0,0,0,0,0,0,0,0,0,0,0,0,0,0,0,0,0,0,0,0
"400 block seneca tpke w, Syracuse, NY",0,0,0,0,0,0,0,0,0,0,0,0,0,0,0,0,0,0,0,0,0,0,0,0,0,0,0,0,0,0,0,0,0,0,0,0
"400 block smith st, Syracuse, NY",12,0,8,4,0,0,0,0,0,0,0,0,0,11,0,0,0,0,0,1,24,3,6,3,0,0,0,0,12,1,11,0,0,0,0,0
"400 block solar st, Syracuse, NY",1,0,0,0,1,0,0,0,0,0,0,0,0,0,1,0,0,0,0,0,2,0,1,0,0,0,0,0,0,0,0,1,0,1,0,0
"400 block south av, Syracuse, NY",31,12,9,2,20,12,7,0,0,0,0,0,5,7,24,0,0,0,0,0,58,13,11,6,0,1,0,0,11,2,9,20,3,17,0,12
"400 block spencer st, Syracuse, NY",42,10,0,0,42,10,9,0,0,0,0,0,1,33,0,0,6,0,0,3,52,32,10,0,0,0,0,0,0,0,0,42,0,42,1,9
"400 block stafford av, Syracuse, NY",1,0,0,0,1,0,0,0,0,0,0,0,0,1,0,0,0,0,0,0,3,0,0,1,0,0,0,0,0,0,0,1,0,1,0,0
"400 block sterling av, Syracuse, NY",33,0,0,1,32,0,0,0,0,0,0,0,0,1,27,1,0,0,2,2,56,20,7,4,0,2,0,0,1,1,0,32,10,22,0,0
"400 block stolp av, Syracuse, NY",0,0,0,0,0,0,0,0,0,0,0,0,0,0,0,0,0,0,0,0,0,0,0,0,0,0,0,0,0,0,0,0,0,0,0,0
"400 block sunset av, Syracuse, NY",0,0,0,0,0,0,0,0,0,0,0,0,0,0,0,0,0,0,0,0,0,0,0,0,0,0,0,0,0,0,0,0,0,0,0,0
"400 block temple st, Syracuse, NY",0,0,0,0,0,0,0,0,0,0,0,0,0,0,0,0,0,0,0,0,0,0,0,0,0,0,0,0,0,0,0,0,0,0,0,0
"400 block thurber st, Syracuse, NY",664,18,15,8,641,18,18,0,0,0,0,0,0,271,207,5,150,0,4,27,1166,287,284,71,15,4,3,0,23,6,17,641,96,545,1,17
"400 block tompkins st, Syracuse, NY",26,0,7,4,15,0,0,0,0,0,0,0,0,24,2,0,0,0,0,0,60,9,6,7,3,0,1,0,11,4,7,15,4,11,0,0
"400 block tully st, Syracuse, NY",0,0,0,0,0,0,0,0,0,0,0,0,0,0,0,0,0,0,0,0,0,0,0,0,0,0,0,0,0,0,0,0,0,0,0,0
"400 block ulster st, Syracuse, NY",84,7,24,9,51,7,4,0,1,0,1,0,1,82,2,0,0,0,0,0,177,28,35,11,6,2,2,0,33,4,29,51,9,42,0,7
"400 block university av, Syracuse, NY",4,13,1,1,2,13,0,0,0,0,0,0,13,1,3,0,0,0,0,0,9,1,2,0,1,0,0,0,2,0,2,2,0,2,0,13
"400 block warren st s, Syracuse, NY",0,0,0,0,0,0,0,0,0,0,0,0,0,0,0,0,0,0,0,0,0,0,0,0,0,0,0,0,0,0,0,0,0,0,0,0
"400 block washington st e, Syracuse, NY",0,0,0,0,0,0,0,0,0,0,0,0,0,0,0,0,0,0,0,0,0,0,0,0,0,0,0,0,0,0,0,0,0,0,0,0
"400 block westcott st, Syracuse, NY",66,1,22,5,39,1,0,1,0,0,0,0,0,55,4,0,6,0,1,0,194,8,17,23,10,6,1,1,27,14,13,39,4,35,0,1
"400 block whittier av, Syracuse, NY",1,0,1,0,0,0,0,0,0,0,0,0,0,1,0,0,0,0,0,0,3,0,0,1,0,0,0,0,1,1,0,0,0,0,0,0
"400 block willis av, Syracuse, NY",0,0,0,0,0,0,0,0,0,0,0,0,0,0,0,0,0,0,0,0,0,0,0,0,0,0,0,0,0,0,0,0,0,0,0,0
"400 block wolf st, Syracuse, NY",20,0,0,6,14,0,0,0,0,0,0,0,0,20,0,0,0,0,0,0,40,10,6,1,2,0,0,1,6,1,5,14,2,12,0,0
"400 block wyoming st, Syracuse, NY",7,7,0,0,7,7,6,0,0,0,0,0,1,5,2,0,0,0,0,0,13,4,1,1,1,0,0,0,0,0,0,7,2,5,0,7
"4000 block salina st s, Syracuse, NY",255,24,50,23,182,24,11,1,1,1,0,0,10,207,39,1,3,0,0,5,366,194,34,16,4,3,3,1,73,14,59,182,1,181,0,24
"4100 block genesee st e, Syracuse, NY",53,4,20,11,22,4,3,0,0,0,0,0,1,8,43,2,0,0,0,0,132,16,12,14,7,3,0,1,31,9,22,22,10,12,0,4
"4100 block salina st s, Syracuse, NY",16,2,7,2,7,2,2,0,0,0,0,0,0,8,8,0,0,0,0,0,38,4,6,4,1,0,1,0,9,0,9,7,4,3,0,2
"4300 block salina st s, Syracuse, NY",29,4,13,4,12,4,0,0,0,0,0,0,4,12,16,1,0,0,0,0,68,12,6,2,7,2,0,0,17,6,11,12,5,7,0,4
"4500 block salina st s, Syracuse, NY",129,9,0,0,129,9,8,1,0,0,0,0,0,15,108,0,0,0,0,6,270,60,28,21,11,7,2,0,0,0,0,129,56,73,0,9
"4600 block salina st s, Syracuse, NY",58,5,33,17,8,5,0,0,1,0,0,0,4,42,15,1,0,0,0,0,132,18,21,7,9,3,0,0,50,11,39,8,2,6,0,5
"4700 block onondaga blvd, Syracuse, NY",10,0,4,6,0,0,0,0,0,0,0,0,0,10,0,0,0,0,0,0,27,2,4,1,1,2,0,0,10,3,7,0,0,0,0,0
"500 block allen st, Syracuse, NY",80,20,24,15,41,20,10,0,0,0,3,0,7,39,37,1,1,0,0,2,224,19,25,9,14,7,5,1,39,13,26,41,21,20,2,18
"500 block avery av, Syracuse, NY",85,9,29,22,34,9,1,0,2,0,0,0,6,80,3,0,0,0,0,2,173,37,27,10,6,3,1,1,51,12,39,34,6,28,0,9
"500 block beattie st, Syracuse, NY",32,2,13,5,14,2,1,0,0,0,1,0,0,2,28,1,1,0,0,0,107,3,11,7,7,1,1,2,18,5,13,14,10,4,0,2
"500 block boyden st, Syracuse, NY",79,4,38,18,23,4,0,0,2,0,0,0,2,67,10,1,0,0,1,0,177,28,28,8,7,7,1,0,56,15,41,23,11,12,0,4
"500 block brattle rd, Syracuse, NY",35,0,14,8,13,0,0,0,0,0,0,0,0,32,1,1,0,0,0,1,82,11,12,5,4,2,1,0,22,10,12,13,1,12,0,0
"500 block bryant av, Syracuse, NY",37,2,9,5,23,2,1,0,0,0,0,0,1,34,2,0,0,0,0,1,91,12,13,6,2,1,0,3,14,0,14,23,10,13,0,2
"500 block burnet av, Syracuse, NY",75,24,5,8,62,24,5,0,0,0,0,0,19,51,17,0,3,0,2,2,165,38,9,13,10,1,3,1,13,3,10,62,21,41,2,22
"500 block burt st, Syracuse, NY",53,1,0,1,52,1,0,0,0,0,0,0,1,1,48,0,0,0,4,0,107,22,18,6,4,3,0,0,1,0,1,52,26,26,1,0
"500 block catherine st, Syracuse, NY",0,0,0,0,0,0,0,0,0,0,0,0,0,0,0,0,0,0,0,0,0,0,0,0,0,0,0,0,0,0,0,0,0,0,0,0
"500 block clarendon st, Syracuse, NY",104,5,40,9,55,5,3,0,0,1,0,0,1,94,4,0,6,0,0,0,301,21,31,18,15,12,6,1,49,16,33,55,4,51,0,5
"500 block clinton st s, Syracuse, NY",0,0,0,0,0,0,0,0,0,0,0,0,0,0,0,0,0,0,0,0,0,0,0,0,0,0,0,0,0,0,0,0,0,0,0,0
"500 block colvin st w, Syracuse, NY",2,0,2,0,0,0,0,0,0,0,0,0,0,0,2,0,0,0,0,0,5,0,1,1,0,0,0,0,2,1,1,0,0,0,0,0
"500 block comstock av, Syracuse, NY",146,9,21,10,115,9,3,2,1,0,3,0,0,82,29,0,24,0,3,8,214,101,32,6,6,0,0,1,31,1,30,115,9,106,2,7
"500 block cortland av, Syracuse, NY",6,9,0,1,5,9,6,2,0,0,0,0,1,1,5,0,0,0,0,0,22,1,2,0,0,1,2,0,1,0,1,5,3,2,3,6
"500 block court st, Syracuse, NY",56,4,5,2,49,4,3,0,0,0,0,0,1,40,6,2,1,0,4,3,102,28,19,3,3,3,0,0,7,0,7,49,6,43,1,3
"500 block crossett st, Syracuse, NY",115,6,65,15,35,6,2,0,0,0,0,0,4,98,13,0,0,0,4,0,293,34,29,26,16,6,2,2,80,23,57,35,19,16,1,5
"500 block crouse av s, Syracuse, NY",0,0,0,0,0,0,0,0,0,0,0,0,0,0,0,0,0,0,0,0,0,0,0,0,0,0,0,0,0,0,0,0,0,0,0,0
"500 block cumberland av, Syracuse, NY",44,3,18,4,22,3,1,0,0,0,1,0,1,36,5,0,3,0,0,0,113,6,15,18,3,1,1,0,22,8,14,22,3,19,0,3
"500 block delaware st, Syracuse, NY",33,7,3,2,28,7,6,0,1,0,0,0,0,11,13,5,0,0,1,3,132,4,5,6,7,2,4,5,5,3,2,28,23,5,2,5
"500 block erie blvd e, Syracuse, NY",0,0,0,0,0,0,0,0,0,0,0,0,0,0,0,0,0,0,0,0,0,0,0,0,0,0,0,0,0,0,0,0,0,0,0,0
"500 block erie blvd w, Syracuse, NY",131,12,0,5,126,12,9,0,0,0,0,0,3,22,87,1,0,0,13,8,375,17,39,46,15,8,2,4,5,2,3,126,90,36,0,12
"500 block franklin st s, Syracuse, NY",37,4,1,0,36,4,4,0,0,0,0,0,0,32,1,0,3,0,0,1,52,24,11,2,0,0,0,0,1,0,1,36,1,35,0,4
"500 block garfield av, Syracuse, NY",46,5,28,9,9,5,0,0,3,0,0,0,2,38,6,0,0,0,0,2,92,21,13,4,7,1,0,0,37,9,28,9,2,7,0,5
"500 block genesee st e, Syracuse, NY",0,0,0,0,0,0,0,0,0,0,0,0,0,0,0,0,0,0,0,0,0,0,0,0,0,0,0,0,0,0,0,0,0,0,0,0
"500 block gifford st, Syracuse, NY",87,19,17,6,64,19,13,0,3,0,0,0,3,36,35,2,0,0,10,4,285,19,13,20,11,14,6,4,23,11,12,64,39,25,4,15
"500 block grand av, Syracuse, NY",49,0,4,2,43,0,0,0,0,0,0,0,0,37,1,2,4,0,1,4,137,16,5,16,4,5,2,1,6,3,3,43,0,43,0,0
"500 block hamilton st, Syracuse, NY",28,1,9,6,13,1,1,0,0,0,0,0,0,28,0,0,0,0,0,0,57,14,7,3,2,0,2,0,15,3,12,13,3,10,0,1
"500 block hawley av, Syracuse, NY",0,0,0,0,0,0,0,0,0,0,0,0,0,0,0,0,0,0,0,0,0,0,0,0,0,0,0,0,0,0,0,0,0,0,0,0
"500 block helen st, Syracuse, NY",31,2,14,6,11,2,1,0,0,0,0,0,1,24,2,2,1,0,0,2,67,13,10,3,2,2,0,1,20,3,17,11,3,8,0,2
"500 block herkimer st, Syracuse, NY",41,1,10,10,21,1,1,0,0,0,0,0,0,38,1,1,0,0,0,1,86,19,12,3,3,3,0,1,20,6,14,21,5,16,0,1
"500 block hixson av, Syracuse, NY",65,3,14,6,45,3,0,0,0,0,0,0,3,58,3,0,1,0,0,3,139,25,24,6,4,4,2,0,20,6,14,45,8,37,0,3
"500 block james st, Syracuse, NY",0,0,0,0,0,0,0,0,0,0,0,0,0,0,0,0,0,0,0,0,0,0,0,0,0,0,0,0,0,0,0,0,0,0,0,0
"500 block jamesville av, Syracuse, NY",40,2,26,12,2,2,1,0,0,1,0,0,0,30,8,1,1,0,0,0,79,16,14,6,3,1,0,0,38,7,31,2,1,1,0,2
"500 block kirkpatrick st, Syracuse, NY",0,0,0,0,0,0,0,0,0,0,0,0,0,0,0,0,0,0,0,0,0,0,0,0,0,0,0,0,0,0,0,0,0,0,0,0
"500 block lemoyne av, Syracuse, NY",78,13,9,11,58,13,1,0,4,0,0,0,8,69,4,1,1,0,0,3,184,23,24,14,14,3,0,0,20,7,13,58,22,36,0,13
"500 block lynch av, Syracuse, NY",25,0,21,4,0,0,0,0,0,0,0,0,0,24,0,0,0,0,1,0,63,4,10,7,2,2,0,0,25,8,17,0,0,0,0,0
"500 block marcellus st, Syracuse, NY",0,0,0,0,0,0,0,0,0,0,0,0,0,0,0,0,0,0,0,0,0,0,0,0,0,0,0,0,0,0,0,0,0,0,0,0
"500 block meadowbrook dr, Syracuse, NY",72,1,39,32,1,1,1,0,0,0,0,0,0,66,4,0,2,0,0,0,135,33,25,7,4,3,0,0,71,10,61,1,0,1,0,1
"500 block northcliffe rd, Syracuse, NY",138,10,65,31,42,10,2,0,0,2,1,0,5,117,11,1,2,0,2,5,312,45,49,18,18,6,1,1,96,25,71,42,17,25,0,10
"500 block nottingham rd, Syracuse, NY",13,1,10,3,0,1,0,0,0,0,0,0,1,12,0,0,1,0,0,0,22,6,5,2,0,0,0,0,13,1,12,0,0,0,0,1
"500 block oakwood av, Syracuse, NY",0,0,0,0,0,0,0,0,0,0,0,0,0,0,0,0,0,0,0,0,0,0,0,0,0,0,0,0,0,0,0,0,0,0,0,0
"500 block onondaga av w, Syracuse, NY",53,5,12,3,38,5,3,1,0,1,0,0,0,8,41,1,0,0,1,2,136,19,12,4,13,2,2,1,15,7,8,38,17,21,0,5
"500 block onondaga st w, Syracuse, NY",22,8,5,5,12,8,2,0,0,0,0,0,6,0,21,0,0,0,1,0,67,7,2,4,4,2,3,0,10,2,8,12,8,4,0,8
"500 block ostrander av w, Syracuse, NY",20,2,11,5,4,2,0,0,1,0,0,0,1,13,5,1,0,0,1,0,48,8,5,2,3,1,0,1,16,3,13,4,1,3,0,2
"500 block park av, Syracuse, NY",0,0,0,0,0,0,0,0,0,0,0,0,0,0,0,0,0,0,0,0,0,0,0,0,0,0,0,0,0,0,0,0,0,0,0,0
"500 block park st, Syracuse, NY",27,9,8,3,16,9,8,0,0,0,0,0,1,18,6,0,2,0,1,0,67,10,7,3,3,2,2,0,11,4,7,16,6,10,0,9
"500 block plum st, Syracuse, NY",0,0,0,0,0,0,0,0,0,0,0,0,0,0,0,0,0,0,0,0,0,0,0,0,0,0,0,0,0,0,0,0,0,0,0,0
"500 block plymouth dr, Syracuse, NY",64,3,37,23,4,3,0,0,1,0,0,0,2,57,3,2,0,0,1,1,142,20,25,7,9,3,0,0,60,15,45,4,2,2,0,3
"500 block pond st, Syracuse, NY",34,11,3,6,25,11,1,1,2,0,0,0,7,18,10,0,4,0,1,1,112,11,4,5,4,4,1,5,9,2,7,25,16,9,0,11
"500 block prospect av, Syracuse, NY",11,13,1,1,9,13,1,0,0,0,0,0,12,6,1,0,4,0,0,0,33,2,3,1,3,2,0,0,2,0,2,9,6,3,0,13
"500 block richmond av, Syracuse, NY",13,13,3,2,8,13,0,7,4,2,0,0,0,13,0,0,0,0,0,0,44,1,3,4,2,1,2,0,5,4,1,8,3,5,0,13
"500 block rowland st, Syracuse, NY",14,1,2,4,8,1,0,1,0,0,0,0,0,6,3,1,0,0,2,2,41,5,3,1,2,0,2,1,6,2,4,8,5,3,0,1
"500 block salina st n, Syracuse, NY",0,0,0,0,0,0,0,0,0,0,0,0,0,0,0,0,0,0,0,0,0,0,0,0,0,0,0,0,0,0,0,0,0,0,0,0
"500 block salina st s, Syracuse, NY",2,18,0,0,2,18,5,0,0,0,0,0,13,2,0,0,0,0,0,0,3,1,1,0,0,0,0,0,0,0,0,2,0,2,0,18
"500 block seneca tpke w, Syracuse, NY",0,0,0,0,0,0,0,0,0,0,0,0,0,0,0,0,0,0,0,0,0,0,0,0,0,0,0,0,0,0,0,0,0,0,0,0
"500 block solar st, Syracuse, NY",2,0,0,1,1,0,0,0,0,0,0,0,0,2,0,0,0,0,0,0,2,2,0,0,0,0,0,0,1,0,1,1,0,1,0,0
"500 block south av, Syracuse, NY",4,1,1,1,2,1,0,0,0,0,0,0,1,0,4,0,0,0,0,0,4,4,0,0,0,0,0,0,2,0,2,2,0,2,0,1
"500 block spring st, Syracuse, NY",35,3,10,8,17,3,2,0,1,0,0,0,0,26,3,1,0,0,2,3,73,16,8,5,4,2,0,0,18,1,17,17,6,11,0,3
"500 block state st s, Syracuse, NY",0,0,0,0,0,0,0,0,0,0,0,0,0,0,0,0,0,0,0,0,0,0,0,0,0,0,0,0,0,0,0,0,0,0,0,0
"500 block stinard av, Syracuse, NY",25,1,19,4,2,1,0,0,0,1,0,0,0,24,0,0,0,0,0,1,57,5,14,3,2,0,0,1,23,3,20,2,1,1,0,1
"500 block tennyson av, Syracuse, NY",37,3,8,3,26,3,0,0,1,0,0,0,2,35,2,0,0,0,0,0,71,20,7,7,1,0,2,0,11,2,9,26,7,19,0,3
"500 block tompkins st, Syracuse, NY",84,5,19,12,53,5,3,0,0,0,0,0,2,79,2,0,2,0,0,1,164,34,31,12,3,4,0,0,31,2,29,53,10,43,0,5
"500 block townsend st n, Syracuse, NY",30,7,1,5,24,7,3,1,0,0,0,0,3,15,9,2,2,0,2,0,77,13,4,6,1,3,2,1,6,0,6,24,11,13,0,7
"500 block townsend st s, Syracuse, NY",14,0,2,1,11,0,0,0,0,0,0,0,0,9,0,0,4,0,0,1,38,6,2,2,1,1,1,1,3,2,1,11,4,7,0,0
"500 block turtle st, Syracuse, NY",14,2,0,2,12,2,1,0,0,0,0,1,0,10,2,0,1,0,0,1,35,5,2,4,2,0,1,0,2,1,1,12,5,7,0,2
"500 block ulster st, Syracuse, NY",133,8,40,27,66,8,2,0,0,1,1,0,4,124,4,2,1,0,0,2,245,60,47,19,3,2,2,0,67,14,53,66,6,60,0,8
"500 block valley dr, Syracuse, NY",31,5,12,1,18,5,0,1,2,0,0,0,2,15,15,1,0,0,0,0,65,12,11,3,3,2,0,0,13,5,8,18,5,13,0,5
"500 block vine st, Syracuse, NY",35,3,11,2,22,3,1,0,0,0,0,0,2,22,9,0,1,0,1,2,81,17,4,9,2,1,0,2,13,4,9,22,3,19,0,3
"500 block walnut av, Syracuse, NY",34,5,0,0,34,5,3,0,0,0,0,0,2,17,16,0,0,0,1,0,42,27,6,1,0,0,0,0,0,0,0,34,2,32,1,4
"500 block wescott st, Syracuse, NY",50,4,21,5,24,4,0,0,1,0,1,0,2,38,10,0,0,0,1,1,129,11,20,8,5,4,1,1,26,9,17,24,6,18,0,4
"500 block west st s, Syracuse, NY",0,84,0,0,0,84,0,0,0,0,0,0,84,0,0,0,0,0,0,0,0,0,0,0,0,0,0,0,0,0,0,0,0,0,0,84
"500 block willow st e, Syracuse, NY",34,31,4,1,29,31,15,0,1,2,0,0,13,23,4,0,7,0,0,0,86,16,8,2,3,1,2,2,5,0,5,29,9,20,2,29
"500 block wolcott av, Syracuse, NY",22,2,14,7,1,2,0,0,1,0,1,0,0,20,1,0,1,0,0,0,38,10,9,2,1,0,0,0,21,3,18,1,0,1,0,2
"5200 block salina st s, Syracuse, NY",25,4,1,0,24,4,4,0,0,0,0,0,0,7,8,0,9,0,0,1,62,11,3,4,3,3,1,0,1,0,1,24,13,11,0,4
"5500 block salina st s, Syracuse, NY",0,0,0,0,0,0,0,0,0,0,0,0,0,0,0,0,0,0,0,0,0,0,0,0,0,0,0,0,0,0,0,0,0,0,0,0
"5800 block salina st s, Syracuse, NY",13,1,8,5,0,1,0,1,0,0,0,0,0,12,0,0,0,0,0,1,32,1,8,2,1,1,0,0,13,3,10,0,0,0,0,1
"600 block ash st, Syracuse, NY",53,7,11,6,36,7,6,0,0,0,0,0,1,25,5,0,19,0,0,4,144,18,10,9,8,6,0,2,17,4,13,36,19,17,0,7
"600 block barnes av, Syracuse, NY",29,1,0,0,29,1,1,0,0,0,0,0,0,8,20,0,0,0,0,1,76,8,6,7,5,3,0,0,0,0,0,29,15,14,0,1
"600 block bear st, Syracuse, NY",82,15,13,6,63,15,6,0,1,0,1,0,7,63,7,3,1,0,0,8,190,33,21,11,10,2,3,2,19,5,14,63,21,42,0,15
"600 block beech st s, Syracuse, NY",12,0,10,1,1,0,0,0,0,0,0,0,0,12,0,0,0,0,0,0,28,2,6,2,2,0,0,0,11,2,9,1,1,0,0,0
"600 block bellevue av, Syracuse, NY",26,7,15,4,7,7,3,0,0,1,0,0,3,10,14,1,0,0,1,0,64,6,8,8,3,0,1,0,19,7,12,7,2,5,1,6
"600 block burnet av, Syracuse, NY",55,5,4,5,46,5,3,0,0,0,0,0,2,28,16,3,3,0,3,2,139,20,12,9,8,3,1,2,9,3,6,46,19,27,0,5
"600 block butternut st, Syracuse, NY",26,5,4,2,20,5,1,0,0,0,0,0,4,19,5,0,0,0,0,2,57,11,10,1,0,1,3,0,6,1,5,20,6,14,0,5
"600 block cannon st, Syracuse, NY",69,22,12,6,51,22,10,0,0,1,1,0,10,7,59,0,0,0,1,2,224,16,13,13,8,10,5,4,18,5,13,51,38,13,2,20
"600 block carbon st, Syracuse, NY",99,28,17,9,73,28,12,1,0,1,2,0,12,18,68,0,9,0,1,3,338,22,16,20,13,10,11,7,26,9,17,73,53,20,2,26
"600 block catherine st, Syracuse, NY",108,60,9,11,88,60,12,0,1,0,0,0,47,62,18,2,22,0,2,2,287,42,21,11,16,7,6,5,20,6,14,88,30,58,0,60
"600 block colvin st w, Syracuse, NY",55,2,37,11,7,2,0,0,0,0,0,0,2,46,9,0,0,0,0,0,118,20,22,5,4,2,1,1,48,11,37,7,0,7,0,2
"600 block comstock av, Syracuse, NY",0,0,0,0,0,0,0,0,0,0,0,0,0,0,0,0,0,0,0,0,0,0,0,0,0,0,0,0,0,0,0,0,0,0,0,0
"600 block court st, Syracuse, NY",43,0,0,0,43,0,0,0,0,0,0,0,0,33,6,0,1,0,1,2,50,36,7,0,0,0,0,0,0,0,0,43,1,42,0,0
"600 block erie blvd w, Syracuse, NY",93,16,9,5,79,16,7,0,1,0,0,0,8,60,20,0,3,0,5,5,212,38,23,13,10,5,4,0,14,3,11,79,25,54,3,13
"600 block euclid av, Syracuse, NY",72,3,29,15,28,3,0,0,1,0,0,0,2,64,4,0,2,0,0,2,166,22,23,14,10,2,1,0,44,12,32,28,7,21,0,3
"600 block geddes st n, Syracuse, NY",0,0,0,0,0,0,0,0,0,0,0,0,0,0,0,0,0,0,0,0,0,0,0,0,0,0,0,0,0,0,0,0,0,0,0,0
"600 block geddes st s, Syracuse, NY",19,4,2,3,14,4,2,0,0,0,0,0,2,11,5,1,0,0,2,0,50,4,6,5,2,1,1,0,5,2,3,14,7,7,0,4
"600 block genesee st e, Syracuse, NY",8,6,0,0,8,6,2,0,0,0,0,0,4,3,2,0,0,0,1,2,18,3,2,1,2,0,0,0,0,0,0,8,2,6,0,6
"600 block genesee st w, Syracuse, NY",21,6,2,1,18,6,2,0,0,0,0,0,4,13,3,0,2,0,1,2,44,10,3,5,2,1,0,0,3,0,3,18,4,14,0,6
"600 block gifford st, Syracuse, NY",43,4,3,6,34,4,0,0,0,0,0,0,4,21,9,0,0,0,10,3,137,7,10,10,5,9,0,2,9,2,7,34,18,16,1,3
"600 block hamilton st, Syracuse, NY",12,2,2,1,9,2,2,0,0,0,0,0,0,10,0,1,0,0,1,0,25,5,2,4,1,0,0,0,3,0,3,9,3,6,0,2
"600 block helen st, Syracuse, NY",31,2,12,8,11,2,1,0,0,0,0,0,1,28,0,0,2,0,0,1,75,7,13,5,3,3,0,0,20,5,15,11,3,8,0,2
"600 block hiawatha blvd w, Syracuse, NY",0,0,0,0,0,0,0,0,0,0,0,0,0,0,0,0,0,0,0,0,0,0,0,0,0,0,0,0,0,0,0,0,0,0,0,0
"600 block hiawatha blvd, Syracuse, NY",0,0,0,0,0,0,0,0,0,0,0,0,0,0,0,0,0,0,0,0,0,0,0,0,0,0,0,0,0,0,0,0,0,0,0,0
"600 block james st, Syracuse, NY",0,0,0,0,0,0,0,0,0,0,0,0,0,0,0,0,0,0,0,0,0,0,0,0,0,0,0,0,0,0,0,0,0,0,0,0
"600 block kirkpatrick st, Syracuse, NY",20,7,8,1,11,7,0,0,0,0,0,0,7,14,4,0,2,0,0,0,60,4,9,3,0,0,1,3,9,3,6,11,6,5,0,7
"600 block lafayette av w, Syracuse, NY",17,1,5,2,10,1,0,0,0,0,0,0,1,0,15,0,0,0,2,0,36,7,5,2,2,1,0,0,7,1,6,10,4,6,0,1
"600 block lemoyne av, Syracuse, NY",53,9,7,8,38,9,9,0,0,0,0,0,0,31,10,0,8,0,0,4,127,17,20,8,3,2,0,3,15,2,13,38,16,22,1,8
"600 block lodi st, Syracuse, NY",0,0,0,0,0,0,0,0,0,0,0,0,0,0,0,0,0,0,0,0,0,0,0,0,0,0,0,0,0,0,0,0,0,0,0,0
"600 block mcbride st n, Syracuse, NY",24,15,3,1,20,15,0,0,0,1,0,0,14,17,4,0,2,0,0,1,64,9,6,3,2,2,1,1,4,0,4,20,8,12,0,15
"600 block mountainview av, Syracuse, NY",140,3,24,10,106,3,0,0,0,0,0,0,3,58,70,0,4,2,2,4,270,63,48,18,4,4,2,1,34,8,26,106,23,83,0,3
"600 block newell st w, Syracuse, NY",128,31,64,11,53,31,9,0,2,0,1,0,19,26,95,1,0,0,1,5,369,30,33,19,26,12,5,3,75,26,49,53,34,19,3,28
"600 block oak st, Syracuse, NY",51,6,5,2,44,6,2,0,0,0,0,0,4,34,11,1,3,0,1,1,136,14,12,8,13,2,2,0,7,3,4,44,18,26,0,6
"600 block oneida st, Syracuse, NY",19,6,5,2,12,6,6,0,0,0,0,0,0,1,18,0,0,0,0,0,58,4,3,6,3,2,0,1,7,4,3,12,9,3,0,6
"600 block onondaga st w, Syracuse, NY",43,37,9,4,30,37,33,1,0,1,0,0,2,10,22,3,0,0,6,2,101,21,9,2,5,3,1,2,13,3,10,30,11,19,2,35
"600 block park av, Syracuse, NY",34,6,1,7,26,6,2,0,0,0,0,0,4,23,10,0,0,0,1,0,59,19,10,2,2,0,1,0,8,0,8,26,4,22,1,5
"600 block park st, Syracuse, NY",77,11,15,4,58,11,2,1,1,0,0,0,7,33,19,0,16,0,2,7,200,23,26,8,11,4,2,3,19,10,9,58,25,33,0,11
"600 block salina st n, Syracuse, NY",24,0,0,0,24,0,0,0,0,0,0,0,0,14,2,0,7,0,1,0,43,17,3,1,1,1,0,1,0,0,0,24,3,21,0,0
"600 block salina st s, Syracuse, NY",0,6,0,0,0,6,0,0,0,0,0,0,6,0,0,0,0,0,0,0,0,0,0,0,0,0,0,0,0,0,0,0,0,0,0,6
"600 block salisbury park dr, Syracuse, NY",21,2,17,3,1,2,0,0,0,0,0,0,2,16,3,0,1,0,0,1,46,6,10,2,2,0,1,0,20,6,14,1,0,1,0,2
"600 block salt springs rd, Syracuse, NY",16,2,11,3,2,2,1,0,1,0,0,0,0,4,9,0,3,0,0,0,31,6,6,3,1,0,0,0,14,3,11,2,0,2,0,2
"600 block schuyler st, Syracuse, NY",0,0,0,0,0,0,0,0,0,0,0,0,0,0,0,0,0,0,0,0,0,0,0,0,0,0,0,0,0,0,0,0,0,0,0,0
"600 block scoville av, Syracuse, NY",67,4,26,14,27,4,1,0,1,0,1,0,1,56,8,0,1,0,1,1,169,22,16,17,5,2,1,4,40,15,25,27,8,19,0,4
"600 block second north st, Syracuse, NY",0,0,0,0,0,0,0,0,0,0,0,0,0,0,0,0,0,0,0,0,0,0,0,0,0,0,0,0,0,0,0,0,0,0,0,0
"600 block sedgwick dr, Syracuse, NY",63,3,37,14,12,3,0,0,0,0,1,0,2,54,8,0,0,0,0,1,159,13,25,15,4,3,2,1,51,16,35,12,6,6,0,3
"600 block seneca tpke w, Syracuse, NY",16,3,8,2,6,3,0,0,0,0,0,0,3,9,6,0,0,0,0,1,41,7,2,3,1,1,2,0,10,3,7,6,3,3,0,3
"600 block seymour st, Syracuse, NY",77,8,17,8,52,8,4,0,1,0,1,0,2,56,9,1,0,0,8,3,179,26,25,11,10,2,1,2,25,5,20,52,22,30,0,8
"600 block south av, Syracuse, NY",3,0,0,2,1,0,0,0,0,0,0,0,0,0,3,0,0,0,0,0,6,1,1,1,0,0,0,0,2,0,2,1,0,1,0,0
"600 block state st n, Syracuse, NY",0,0,0,0,0,0,0,0,0,0,0,0,0,0,0,0,0,0,0,0,0,0,0,0,0,0,0,0,0,0,0,0,0,0,0,0
"600 block teall av, Syracuse, NY",101,5,36,23,42,5,2,0,2,0,0,0,1,79,16,0,0,0,1,5,241,35,27,20,10,5,2,2,59,16,43,42,16,26,0,5
"600 block tompkins st, Syracuse, NY",12,1,5,5,2,1,0,0,0,0,0,0,1,12,0,0,0,0,0,0,31,1,6,3,1,1,0,0,10,2,8,2,0,2,0,1
"600 block townsend st n, Syracuse, NY",2,3,2,0,0,3,0,0,0,0,0,0,3,2,0,0,0,0,0,0,2,2,0,0,0,0,0,0,2,0,2,0,0,0,0,3
"600 block turtle st, Syracuse, NY",87,9,17,16,54,9,3,0,0,1,1,0,4,77,6,0,2,0,1,1,208,28,32,13,5,3,2,4,33,5,28,54,17,37,0,9
"600 block vine st, Syracuse, NY",20,2,14,3,3,2,1,0,0,0,1,0,0,20,0,0,0,0,0,0,50,4,9,3,2,1,1,0,17,7,10,3,1,2,0,2
"600 block walnut st, Syracuse, NY",0,0,0,0,0,0,0,0,0,0,0,0,0,0,0,0,0,0,0,0,0,0,0,0,0,0,0,0,0,0,0,0,0,0,0,0
"600 block west st s, Syracuse, NY",0,0,0,0,0,0,0,0,0,0,0,0,0,0,0,0,0,0,0,0,0,0,0,0,0,0,0,0,0,0,0,0,0,0,0,0
"600 block willow st e, Syracuse, NY",274,23,0,0,274,23,16,0,0,0,7,0,0,176,54,1,36,0,0,7,369,205,52,11,4,1,1,0,0,0,0,274,26,248,1,22
"600 block wolf st, Syracuse, NY",0,0,0,0,0,0,0,0,0,0,0,0,0,0,0,0,0,0,0,0,0,0,0,0,0,0,0,0,0,0,0,0,0,0,0,0
"700 block ackerman av, Syracuse, NY",43,3,13,5,25,3,0,0,0,0,1,0,2,32,2,1,7,0,1,0,112,9,11,15,5,2,1,0,18,6,12,25,2,23,0,3
"700 block adams st e, Syracuse, NY",58,3,0,0,58,3,0,0,0,0,0,0,3,7,48,1,0,0,0,2,135,17,21,11,3,5,1,0,0,0,0,58,35,23,0,3
"700 block adams st w, Syracuse, NY",0,0,0,0,0,0,0,0,0,0,0,0,0,0,0,0,0,0,0,0,0,0,0,0,0,0,0,0,0,0,0,0,0,0,0,0
"700 block allen st, Syracuse, NY",38,1,14,6,18,1,0,0,0,0,0,0,1,33,1,0,3,0,0,1,82,16,9,7,4,1,1,0,20,4,16,18,4,14,0,1
"700 block ash st, Syracuse, NY",15,6,0,0,15,6,0,0,0,0,0,0,6,8,5,1,0,0,1,0,48,2,4,4,2,1,1,1,0,0,0,15,9,6,0,6
"700 block avery av, Syracuse, NY",76,11,20,10,46,11,1,0,1,1,0,0,8,72,2,0,0,0,1,1,171,30,20,9,14,1,1,1,30,9,21,46,12,34,0,11
"700 block ballantyne rd, Syracuse, NY",65,2,23,10,32,2,1,0,1,0,0,0,0,25,36,1,0,0,0,3,161,19,23,7,11,2,1,2,33,15,18,32,15,17,0,2
"700 block bear st, Syracuse, NY",46,3,10,7,29,3,1,0,0,0,0,0,2,36,7,1,0,0,0,2,120,15,16,5,4,3,0,3,17,4,13,29,13,16,0,3
"700 block brighton av e, Syracuse, NY",0,0,0,0,0,0,0,0,0,0,0,0,0,0,0,0,0,0,0,0,0,0,0,0,0,0,0,0,0,0,0,0,0,0,0,0
"700 block butternut st, Syracuse, NY",142,15,12,15,115,15,5,0,1,0,0,0,9,62,29,2,40,0,5,4,459,43,23,22,19,13,7,15,27,10,17,115,58,57,1,14
"700 block carbon st, Syracuse, NY",76,14,5,10,61,14,3,0,1,0,0,0,10,42,23,0,4,0,4,3,191,26,13,20,8,7,2,0,15,4,11,61,32,29,0,14
"700 block catherine st, Syracuse, NY",0,0,0,0,0,0,0,0,0,0,0,0,0,0,0,0,0,0,0,0,0,0,0,0,0,0,0,0,0,0,0,0,0,0,0,0
"700 block crawford av, Syracuse, NY",3,0,1,2,0,0,0,0,0,0,0,0,0,3,0,0,0,0,0,0,4,2,1,0,0,0,0,0,3,0,3,0,0,0,0,0
"700 block danforth st, Syracuse, NY",39,5,6,2,31,5,4,0,0,1,0,0,0,18,9,1,8,0,0,3,124,7,11,7,6,4,1,3,8,4,4,31,15,16,0,5
"700 block erie blvd e, Syracuse, NY",331,30,1,1,329,30,30,0,0,0,0,0,0,218,95,4,5,0,0,9,395,278,45,6,1,1,0,0,2,0,2,329,9,320,2,28
"700 block euclid av, Syracuse, NY",57,2,22,9,26,2,2,0,0,0,0,0,0,50,4,1,1,0,1,0,154,11,20,10,10,4,1,1,31,11,20,26,1,25,0,2
"700 block geddes st s, Syracuse, NY",15,9,1,2,12,9,2,0,0,0,0,0,7,5,9,0,0,0,0,1,69,0,2,3,4,3,1,2,3,0,3,12,10,2,0,9
"700 block genesee st e, Syracuse, NY",0,0,0,0,0,0,0,0,0,0,0,0,0,0,0,0,0,0,0,0,0,0,0,0,0,0,0,0,0,0,0,0,0,0,0,0
"700 block glenwood av, Syracuse, NY",39,0,22,5,12,0,0,0,0,0,0,0,0,35,4,0,0,0,0,0,119,4,15,6,8,3,1,2,27,12,15,12,6,6,0,0
"700 block hamilton st, Syracuse, NY",9,1,5,2,2,1,0,0,0,0,0,0,1,9,0,0,0,0,0,0,24,2,3,1,2,1,0,0,7,1,6,2,2,0,0,1
"700 block hazelwood av, Syracuse, NY",131,9,36,11,84,9,3,0,1,0,0,0,5,63,56,0,6,0,4,2,271,60,33,19,11,6,0,2,47,13,34,84,16,68,2,7
"700 block irving av, Syracuse, NY",292,12,1,1,290,12,11,0,0,0,0,0,1,139,145,0,3,0,2,3,314,273,16,3,0,0,0,0,2,0,2,290,1,289,1,11
"700 block lancaster av, Syracuse, NY",58,3,19,11,28,3,1,1,0,0,0,0,1,46,1,0,4,0,1,6,165,12,15,14,8,7,1,1,30,7,23,28,5,23,0,3
"700 block livingston av, Syracuse, NY",0,0,0,0,0,0,0,0,0,0,0,0,0,0,0,0,0,0,0,0,0,0,0,0,0,0,0,0,0,0,0,0,0,0,0,0
"700 block marcellus st, Syracuse, NY",4,0,0,0,4,0,0,0,0,0,0,0,0,2,0,0,0,0,2,0,8,1,2,1,0,0,0,0,0,0,0,4,1,3,0,0
"700 block mcbride st n, Syracuse, NY",27,3,4,3,20,3,1,0,0,0,0,0,2,8,10,0,4,0,4,1,97,3,8,4,4,4,1,3,7,4,3,20,11,9,0,3
"700 block milton av, Syracuse, NY",1,0,0,0,1,0,0,0,0,0,0,0,0,1,0,0,0,0,0,0,1,1,0,0,0,0,0,0,0,0,0,1,0,1,0,0
"700 block newell st w, Syracuse, NY",128,6,0,0,128,6,3,0,0,0,0,0,3,105,15,3,2,0,0,3,140,117,10,1,0,0,0,0,0,0,0,128,3,125,0,6
"700 block onondaga st w, Syracuse, NY",19,4,2,5,12,4,3,0,0,0,0,0,1,9,3,0,7,0,0,0,64,6,2,2,1,5,2,1,7,0,7,12,8,4,0,4
"700 block salina st s, Syracuse, NY",1,0,0,0,1,0,0,0,0,0,0,0,0,1,0,0,0,0,0,0,1,1,0,0,0,0,0,0,0,0,0,1,0,1,0,0
"700 block salt springs rd, Syracuse, NY",12,2,10,2,0,2,0,0,1,0,1,0,0,10,1,0,1,0,0,0,43,1,5,1,1,1,1,2,12,4,8,0,0,0,0,2
"700 block schuyler st, Syracuse, NY",0,0,0,0,0,0,0,0,0,0,0,0,0,0,0,0,0,0,0,0,0,0,0,0,0,0,0,0,0,0,0,0,0,0,0,0
"700 block seeley rd, Syracuse, NY",17,1,8,8,1,1,1,0,0,0,0,0,0,12,5,0,0,0,0,0,31,6,8,3,0,0,0,0,16,1,15,1,1,0,1,0
"700 block seneca tpke w, Syracuse, NY",0,0,0,0,0,0,0,0,0,0,0,0,0,0,0,0,0,0,0,0,0,0,0,0,0,0,0,0,0,0,0,0,0,0,0,0
"700 block stinard av, Syracuse, NY",11,0,8,2,1,0,0,0,0,0,0,0,0,9,1,0,1,0,0,0,27,2,5,3,0,0,1,0,10,3,7,1,0,1,0,0
"700 block stolp av, Syracuse, NY",59,2,38,14,7,2,1,0,0,0,1,0,0,54,5,0,0,0,0,0,148,14,21,11,7,5,1,0,52,17,35,7,3,4,0,2
"700 block sumner av, Syracuse, NY",29,0,10,1,18,0,0,0,0,0,0,0,0,23,0,0,4,0,0,2,84,8,10,2,4,2,1,2,11,5,6,18,0,18,0,0
"700 block townsend st n, Syracuse, NY",27,2,1,1,25,2,0,0,0,0,0,0,2,6,9,1,9,0,0,2,77,10,5,2,5,3,1,1,2,2,0,25,12,13,0,2
"700 block tully st, Syracuse, NY",21,5,6,3,12,5,0,0,1,0,0,0,4,10,7,1,0,0,2,1,69,2,6,5,4,2,0,2,9,6,3,12,4,8,2,3
"700 block university av, Syracuse, NY",31,4,0,0,31,4,0,0,0,0,0,0,4,29,0,0,2,0,0,0,88,6,6,8,9,2,0,0,0,0,0,31,1,30,0,4
"700 block valley dr, Syracuse, NY",21,3,9,2,10,3,0,0,1,1,0,0,1,9,12,0,0,0,0,0,57,3,7,8,1,1,0,1,11,3,8,10,6,4,3,0
"700 block van rensselaer st, Syracuse, NY",0,0,0,0,0,0,0,0,0,0,0,0,0,0,0,0,0,0,0,0,0,0,0,0,0,0,0,0,0,0,0,0,0,0,0,0
"700 block vanrensselear st, Syracuse, NY",3,0,0,0,3,0,0,0,0,0,0,0,0,2,0,1,0,0,0,0,7,1,0,2,0,0,0,0,0,0,0,3,2,1,0,0
"700 block wadsworth st, Syracuse, NY",41,5,14,14,13,5,1,0,1,0,1,0,2,38,2,1,0,0,0,0,91,17,11,6,4,1,1,1,28,3,25,13,8,5,0,5
"700 block warren st s, Syracuse, NY",0,0,0,0,0,0,0,0,0,0,0,0,0,0,0,0,0,0,0,0,0,0,0,0,0,0,0,0,0,0,0,0,0,0,0,0
"700 block west st s, Syracuse, NY",145,3,0,0,145,3,3,0,0,0,0,0,0,18,93,0,1,0,26,7,301,58,45,25,10,5,1,1,0,0,0,145,71,74,1,2
"700 block westcott st, Syracuse, NY",1,0,1,0,0,0,0,0,0,0,0,0,0,1,0,0,0,0,0,0,2,0,1,0,0,0,0,0,1,0,1,0,0,0,0,0
"700 block westmoreland av, Syracuse, NY",0,0,0,0,0,0,0,0,0,0,0,0,0,0,0,0,0,0,0,0,0,0,0,0,0,0,0,0,0,0,0,0,0,0,0,0
"700 block wolf st, Syracuse, NY",28,4,6,7,15,4,1,0,0,0,0,0,3,24,3,0,0,0,1,0,65,8,13,3,2,0,1,1,13,1,12,15,8,7,0,4
"800 block alvord st n, Syracuse, NY",28,6,7,1,20,6,2,0,0,0,0,0,4,16,4,1,4,0,0,3,86,8,4,4,6,3,2,1,8,3,5,20,12,8,0,6
"800 block belden av w, Syracuse, NY",0,0,0,0,0,0,0,0,0,0,0,0,0,0,0,0,0,0,0,0,0,0,0,0,0,0,0,0,0,0,0,0,0,0,0,0
"800 block burnet av, Syracuse, NY",47,10,5,5,37,10,5,0,0,0,0,0,5,35,8,0,1,0,2,1,98,24,9,6,4,3,0,1,10,2,8,37,9,28,1,9
"800 block butternut st, Syracuse, NY",81,21,11,3,67,21,5,1,0,0,0,0,15,43,24,0,10,0,2,2,228,20,24,13,11,6,6,1,14,3,11,67,31,36,5,16
"800 block clinton st n, Syracuse, NY",31,14,0,1,30,14,14,0,0,0,0,0,0,21,5,1,1,0,1,2,60,17,8,1,2,2,1,0,1,1,0,30,7,23,1,13
"800 block colvin st w, Syracuse, NY",70,15,26,10,34,15,1,0,0,0,0,0,14,11,55,4,0,0,0,0,207,16,16,18,7,8,2,3,36,11,25,34,20,14,1,14
"800 block darlington rd, Syracuse, NY",23,2,9,8,6,2,0,0,2,0,0,0,0,23,0,0,0,0,0,0,47,9,8,4,0,2,0,0,17,4,13,6,0,6,0,2
"800 block division st e, Syracuse, NY",28,5,6,6,16,5,0,0,0,0,0,0,5,19,4,0,5,0,0,0,100,9,5,3,2,4,1,4,12,3,9,16,10,6,0,5
"800 block emerson av, Syracuse, NY",15,1,4,1,10,1,0,0,0,0,0,0,1,11,2,1,0,0,0,1,31,7,5,0,1,2,0,0,5,1,4,10,4,6,0,1
"800 block erie blvd e, Syracuse, NY",0,0,0,0,0,0,0,0,0,0,0,0,0,0,0,0,0,0,0,0,0,0,0,0,0,0,0,0,0,0,0,0,0,0,0,0
"800 block erie blvd w, Syracuse, NY",13,8,2,5,6,8,6,0,0,2,0,0,0,8,2,2,0,0,1,0,41,3,4,3,0,1,1,1,7,2,5,6,3,3,0,8
"800 block euclid av, Syracuse, NY",51,4,15,9,27,4,2,0,2,0,0,0,0,41,3,0,7,0,0,0,112,18,17,6,8,2,0,0,24,7,17,27,4,23,0,4
"800 block fayette st w, Syracuse, NY",14,8,3,3,8,8,7,1,0,0,0,0,0,2,6,0,0,0,5,1,37,4,3,3,3,0,1,0,6,2,4,8,5,3,0,8
"800 block geddes st n, Syracuse, NY",86,20,11,4,71,20,12,0,0,0,0,0,8,58,17,3,1,0,0,7,287,17,14,18,16,9,7,5,15,4,11,71,48,23,2,18
"800 block geddes st s, Syracuse, NY",58,15,3,5,50,15,1,0,0,0,0,0,14,27,19,2,0,0,6,4,211,7,12,14,8,8,4,5,8,4,4,50,35,15,3,12
"800 block genesee st e, Syracuse, NY",0,0,0,0,0,0,0,0,0,0,0,0,0,0,0,0,0,0,0,0,0,0,0,0,0,0,0,0,0,0,0,0,0,0,0,0
"800 block genesee st w, Syracuse, NY",0,0,0,0,0,0,0,0,0,0,0,0,0,0,0,0,0,0,0,0,0,0,0,0,0,0,0,0,0,0,0,0,0,0,0,0
"800 block hazelwood av, Syracuse, NY",19,0,11,3,5,0,0,0,0,0,0,0,0,9,9,0,0,0,1,0,40,5,10,2,1,1,0,0,14,2,12,5,1,4,0,0
"800 block hiawatha blvd w, Syracuse, NY",0,0,0,0,0,0,0,0,0,0,0,0,0,0,0,0,0,0,0,0,0,0,0,0,0,0,0,0,0,0,0,0,0,0,0,0
"800 block highland st, Syracuse, NY",91,27,16,9,66,27,3,0,3,2,0,0,19,50,22,3,9,0,1,6,301,20,18,14,15,11,7,6,25,8,17,66,42,24,1,26
"800 block ivy ridge rd, Syracuse, NY",73,6,39,10,24,6,2,0,0,0,0,0,4,31,34,0,4,0,0,4,193,25,16,11,9,8,2,2,49,16,33,24,8,16,4,2
"800 block james st, Syracuse, NY",83,11,11,10,62,11,5,0,1,1,0,0,4,45,22,1,10,0,1,4,189,33,21,15,7,3,2,2,21,8,13,62,23,39,1,10
"800 block lafayette av w, Syracuse, NY",0,0,0,0,0,0,0,0,0,0,0,0,0,0,0,0,0,0,0,0,0,0,0,0,0,0,0,0,0,0,0,0,0,0,0,0
"800 block livingston av, Syracuse, NY",154,2,26,12,116,2,0,2,0,0,0,0,0,128,9,2,7,0,2,6,408,43,42,29,17,12,11,0,38,12,26,116,5,111,0,2
"800 block maryland av, Syracuse, NY",46,1,11,1,34,1,0,0,1,0,0,0,0,34,7,0,2,0,1,2,116,12,16,8,6,1,2,1,12,5,7,34,4,30,0,1
"800 block onondaga av, Syracuse, NY",40,8,12,7,21,8,4,0,1,2,0,0,1,18,21,0,0,0,1,0,107,11,9,11,5,1,1,2,19,5,14,21,12,9,0,8
"800 block ostom av, Syracuse, NY",0,0,0,0,0,0,0,0,0,0,0,0,0,0,0,0,0,0,0,0,0,0,0,0,0,0,0,0,0,0,0,0,0,0,0,0
"800 block ostrom av, Syracuse, NY",0,0,0,0,0,0,0,0,0,0,0,0,0,0,0,0,0,0,0,0,0,0,0,0,0,0,0,0,0,0,0,0,0,0,0,0
"800 block park st, Syracuse, NY",34,18,1,2,31,18,2,0,0,0,0,0,16,14,12,1,6,0,1,0,98,9,10,5,3,4,2,1,3,1,2,31,17,14,0,18
"800 block salina st s, Syracuse, NY",95,33,2,1,92,33,32,0,0,0,0,0,1,58,27,0,4,0,3,3,152,64,20,6,3,1,0,1,3,0,3,92,14,78,0,33
"800 block salt springs rd, Syracuse, NY",36,3,29,5,2,3,1,0,1,0,0,0,1,15,20,0,0,0,0,1,98,10,9,8,5,2,1,1,34,17,17,2,1,1,1,2
"800 block sumner av, Syracuse, NY",120,1,19,6,95,1,0,0,0,0,0,0,1,99,8,0,7,0,0,6,307,27,48,23,11,3,5,3,25,9,16,95,5,90,0,1
"800 block townsend st n, Syracuse, NY",0,0,0,0,0,0,0,0,0,0,0,0,0,0,0,0,0,0,0,0,0,0,0,0,0,0,0,0,0,0,0,0,0,0,0,0
"800 block turtle st, Syracuse, NY",46,3,15,6,25,3,0,2,0,0,0,0,1,39,3,1,0,0,0,3,108,20,11,5,6,1,1,2,21,4,17,25,9,16,0,3
"800 block vanrensselaer st, Syracuse, NY",0,0,0,0,0,0,0,0,0,0,0,0,0,0,0,0,0,0,0,0,0,0,0,0,0,0,0,0,0,0,0,0,0,0,0,0
"800 block wadsworth st, Syracuse, NY",41,1,24,14,3,1,0,0,0,0,0,0,1,41,0,0,0,0,0,0,84,18,10,6,7,0,0,0,38,8,30,3,0,3,0,1
"800 block willow st e, Syracuse, NY",0,0,0,0,0,0,0,0,0,0,0,0,0,0,0,0,0,0,0,0,0,0,0,0,0,0,0,0,0,0,0,0,0,0,0,0
"800 block wolf st, Syracuse, NY",0,0,0,0,0,0,0,0,0,0,0,0,0,0,0,0,0,0,0,0,0,0,0,0,0,0,0,0,0,0,0,0,0,0,0,0
"900 block avery av, Syracuse, NY",25,0,2,2,21,0,0,0,0,0,0,0,0,21,2,2,0,0,0,0,67,6,5,8,3,3,0,0,4,1,3,21,11,10,0,0
"900 block brighton av e, Syracuse, NY",48,0,0,0,48,0,0,0,0,0,0,0,0,5,40,0,0,0,0,3,92,22,13,8,5,0,0,0,0,0,0,48,21,27,0,0
"900 block burnet av, Syracuse, NY",1,0,0,0,1,0,0,0,0,0,0,0,0,0,1,0,0,0,0,0,5,0,0,0,0,1,0,0,0,0,0,1,1,0,0,0
"900 block butternut st, Syracuse, NY",23,12,5,6,12,12,9,0,0,0,0,0,3,10,5,0,3,0,3,2,81,3,4,6,4,3,1,2,11,2,9,12,10,2,0,12
"900 block canal st, Syracuse, NY",0,0,0,0,0,0,0,0,0,0,0,0,0,0,0,0,0,0,0,0,0,0,0,0,0,0,0,0,0,0,0,0,0,0,0,0
"900 block clinton st n, Syracuse, NY",0,0,0,0,0,0,0,0,0,0,0,0,0,0,0,0,0,0,0,0,0,0,0,0,0,0,0,0,0,0,0,0,0,0,0,0
"900 block comstock av, Syracuse, NY",169,33,13,3,153,33,16,2,0,0,0,0,15,113,21,1,18,0,8,8,263,111,39,12,3,0,2,2,16,0,16,153,8,145,0,33
"900 block danforth st, Syracuse, NY",266,21,33,22,211,21,4,0,1,1,0,0,15,203,39,4,12,0,2,6,505,168,42,19,15,10,7,5,55,18,37,211,33,178,1,20
"900 block darlington rd, Syracuse, NY",35,2,23,8,4,2,0,0,0,0,0,0,2,33,0,0,0,0,2,0,68,14,13,4,4,0,0,0,31,4,27,4,2,2,0,2
"900 block dewitt st, Syracuse, NY",0,0,0,0,0,0,0,0,0,0,0,0,0,0,0,0,0,0,0,0,0,0,0,0,0,0,0,0,0,0,0,0,0,0,0,0
"900 block emerson av, Syracuse, NY",13,0,1,3,9,0,0,0,0,0,0,0,0,11,2,0,0,0,0,0,38,3,4,1,3,0,2,0,4,1,3,9,5,4,0,0
"900 block erie blvd w, Syracuse, NY",8,1,2,1,5,1,0,0,0,0,0,0,1,8,0,0,0,0,0,0,11,7,0,0,1,0,0,0,3,0,3,5,1,4,0,1
"900 block euclid av, Syracuse, NY",70,2,6,1,63,2,0,0,0,0,1,0,1,54,6,0,8,0,2,0,171,17,24,17,7,3,2,0,7,4,3,63,5,58,0,2
"900 block first north st, Syracuse, NY",49,2,3,3,43,2,1,0,0,0,0,0,1,21,25,0,2,0,0,1,109,16,19,8,4,1,0,1,6,2,4,43,17,26,0,2
"900 block geddes st s, Syracuse, NY",70,5,0,0,70,5,3,0,0,0,0,0,2,3,53,0,0,0,10,4,254,1,9,27,19,9,3,2,0,0,0,70,62,8,0,5
"900 block genesee st e, Syracuse, NY",196,3,0,0,196,3,1,2,0,0,0,0,0,100,76,3,14,0,0,3,219,174,21,1,0,0,0,0,0,0,0,196,0,196,0,3
"900 block genesee st w, Syracuse, NY",35,11,4,3,28,11,1,0,0,0,0,0,10,19,10,1,0,0,0,5,93,13,4,7,4,7,0,0,7,1,6,28,14,14,0,11
"900 block glencove rd, Syracuse, NY",143,13,47,19,77,13,11,0,1,0,0,0,1,123,10,1,4,0,2,3,324,44,51,27,12,6,2,1,66,16,50,77,27,50,0,13
"900 block glenwood av, Syracuse, NY",61,0,42,17,2,0,0,0,0,0,0,0,0,56,3,1,0,0,0,1,148,15,23,7,14,2,0,0,59,16,43,2,0,2,0,0
"900 block harrison st, Syracuse, NY",0,0,0,0,0,0,0,0,0,0,0,0,0,0,0,0,0,0,0,0,0,0,0,0,0,0,0,0,0,0,0,0,0,0,0,0
"900 block hawley av, Syracuse, NY",0,0,0,0,0,0,0,0,0,0,0,0,0,0,0,0,0,0,0,0,0,0,0,0,0,0,0,0,0,0,0,0,0,0,0,0
"900 block hiawatha blvd, Syracuse, NY",43,8,12,6,25,8,2,0,3,0,0,0,3,35,6,0,0,0,1,1,141,9,11,6,7,5,2,3,18,6,12,25,15,10,2,6
"900 block highland st, Syracuse, NY",0,0,0,0,0,0,0,0,0,0,0,0,0,0,0,0,0,0,0,0,0,0,0,0,0,0,0,0,0,0,0,0,0,0,0,0
"900 block irving av, Syracuse, NY",0,0,0,0,0,0,0,0,0,0,0,0,0,0,0,0,0,0,0,0,0,0,0,0,0,0,0,0,0,0,0,0,0,0,0,0
"900 block james st, Syracuse, NY",111,34,8,4,99,34,6,0,0,0,2,0,26,67,25,2,12,0,0,5,179,75,20,7,6,1,1,1,12,6,6,99,6,93,2,32
"900 block jamesville av, Syracuse, NY",3,0,0,0,3,0,0,0,0,0,0,0,0,2,1,0,0,0,0,0,5,2,0,1,0,0,0,0,0,0,0,3,0,3,0,0
"900 block kirkpatrick st, Syracuse, NY",55,3,24,8,23,3,1,0,0,0,0,0,2,47,3,1,0,0,4,0,155,13,16,10,5,8,1,2,32,10,22,23,10,13,1,2,0,0,,,,,,,,,,,,,,
"900 block lafayette av w, Syracuse, NY",14,5,8,3,3,5,4,0,0,0,0,0,1,9,4,0,0,0,0,1,33,4,5,2,2,1,0,0,11,2,9,3,2,1,0,5
"900 block lemoyne av, Syracuse, NY",66,21,3,5,58,21,11,5,1,0,0,0,4,43,17,2,2,0,0,2,136,38,10,7,4,3,2,2,8,0,8,58,16,42,1,20
"900 block oak st, Syracuse, NY",9,1,4,1,4,1,0,0,0,0,0,0,1,9,0,0,0,0,0,0,20,3,3,2,0,1,0,0,5,0,5,4,2,2,0,1
"900 block park av, Syracuse, NY",0,0,0,0,0,0,0,0,0,0,0,0,0,0,0,0,0,0,0,0,0,0,0,0,0,0,0,0,0,0,0,0,0,0,0,0
"900 block park st, Syracuse, NY",14,0,8,1,5,0,0,0,0,0,0,0,0,11,0,2,0,0,0,1,36,2,5,5,1,1,0,0,9,2,7,5,3,2,0,0
"900 block salina st n, Syracuse, NY",4,1,3,1,0,1,1,0,0,0,0,0,0,0,4,0,0,0,0,0,12,1,1,1,0,0,1,0,4,1,3,0,0,0,0,1
"900 block salina st s, Syracuse, NY",90,2,0,0,90,2,2,0,0,0,0,0,0,5,78,0,0,0,3,4,218,21,34,20,11,3,0,1,0,0,0,90,59,31,0,2
"900 block salt springs rd, Syracuse, NY",49,1,30,10,9,1,0,0,1,0,0,0,0,31,14,1,0,0,1,2,116,10,24,6,6,2,1,0,40,7,33,9,4,5,1,0
"900 block south av, Syracuse, NY",4,0,1,1,2,0,0,0,0,0,0,0,0,1,3,0,0,0,0,0,10,1,1,1,1,0,0,0,2,1,1,2,0,2,0,0
"900 block spring st, Syracuse, NY",14,3,7,3,4,3,0,0,0,0,0,0,3,6,2,0,3,0,2,1,51,0,4,1,7,0,2,0,10,6,4,4,3,1,1,2
"900 block state st n, Syracuse, NY",0,0,0,0,0,0,0,0,0,0,0,0,0,0,0,0,0,0,0,0,0,0,0,0,0,0,0,0,0,0,0,0,0,0,0,0
"900 block townsend st n, Syracuse, NY",0,0,0,0,0,0,0,0,0,0,0,0,0,0,0,0,0,0,0,0,0,0,0,0,0,0,0,0,0,0,0,0,0,0,0,0,0,0,,,,,,,,,,,,,,
"900 block townsend st s, Syracuse, NY",0,0,0,0,0,0,0,0,0,0,0,0,0,0,0,0,0,0,0,0,0,0,0,0,0,0,0,0,0,0,0,0,0,0,0,0
"900 block walnut av, Syracuse, NY",1,0,0,0,1,0,0,0,0,0,0,0,0,0,1,0,0,0,0,0,1,1,0,0,0,0,0,0,0,0,0,1,0,1,0,0
"900 block westcott st, Syracuse, NY",16,2,9,7,0,2,2,0,0,0,0,0,0,15,1,0,0,0,0,0,22,11,4,1,0,0,0,0,16,1,15,0,0,0,0,2
"900 block westmoreland av, Syracuse, NY",35,2,22,12,1,2,0,0,1,0,0,0,1,31,4,0,0,0,0,0,81,5,19,7,3,1,0,0,34,8,26,1,0,1,0,2
"900 block willis av, Syracuse, NY",0,0,0,0,0,0,0,0,0,0,0,0,0,0,0,0,0,0,0,0,0,0,0,0,0,0,0,0,0,0,0,0,0,0,0,0
